Publisher	count	Unconquerables	% Unconquerables	MEDLINE journals OA compliant	% MEDLINE journals OA compliant
Annual Reviews	24	21	0.875	3	0.125
Academic Press	56	15	0.26785714285714285	41	0.7321428571428571
Elsevier	355	14	0.03943661971830986	341	0.9605633802816902
Karger	42	13	0.30952380952380953	29	0.6904761904761905
Springer Medizin	11	10	0.9090909090909091	1	0.09090909090909091
Media Sfera	9	9	1.0	0	0.0
Edizioni Minerva Medica	11	7	0.6363636363636364	4	0.36363636363636365
Springer	151	7	0.046357615894039736	144	0.9536423841059603
Chinese Medical Association	6	6	1.0	0	0.0
Zhonghua yi xue hui	6	6	1.0	0	0.0
Quintessence Pub. Co.	5	5	1.0	0	0.0
Elsevier Inc.	14	5	0.35714285714285715	9	0.6428571428571429
Karger.	22	5	0.22727272727272727	17	0.7727272727272727
Springer-Verlag.	22	5	0.22727272727272727	17	0.7727272727272727
American Association of Neurological Surgeons	4	4	1.0	0	0.0
Il Pensiero Scientifico Editore	4	4	1.0	0	0.0
Cold Spring Harbor Laboratory Press	9	4	0.4444444444444444	5	0.5555555555555556
Academic Press.	13	4	0.3076923076923077	9	0.6923076923076923
Springer Verlag	37	4	0.10810810810810811	33	0.8918918918918919
SAGE Publications	46	4	0.08695652173913043	42	0.9130434782608695
Wiley	119	4	0.03361344537815126	115	0.9663865546218487
Frontline Medical Communications	3	3	1.0	0	0.0
Guilford Press	3	3	1.0	0	0.0
International Scientific Information, Inc.	3	3	1.0	0	0.0
Masson.	5	3	0.6	2	0.4
The Association	5	3	0.6	2	0.4
Via Medica	6	3	0.5	3	0.5
Wolters Kluwer	13	3	0.23076923076923078	10	0.7692307692307693
Lippincott Williams & Wilkins	149	3	0.020134228187919462	146	0.9798657718120806
American Academy of Pediatric Dentistry	2	2	1.0	0	0.0
American Association for Laboratory Animal Science	2	2	1.0	0	0.0
Canadian Veterinary Medical Association	2	2	1.0	0	0.0
EB Medicine	2	2	1.0	0	0.0
Elsevier España, S.L.U.	2	2	1.0	0	0.0
InnoVision Communications	2	2	1.0	0	0.0
Ke xue chu ban she	2	2	1.0	0	0.0
Mattioli 1885	2	2	1.0	0	0.0
Medit︠s︡ina	2	2	1.0	0	0.0
Prime National Pub. Corp.	2	2	1.0	0	0.0
Societa Editrice Universo	2	2	1.0	0	0.0
U.S. National Center for Health Statistics	2	2	1.0	0	0.0
World Scientific	2	2	1.0	0	0.0
American Academy of Pediatrics	3	2	0.6666666666666666	1	0.3333333333333333
Annual Reviews Inc.	3	2	0.6666666666666666	1	0.3333333333333333
Urban & Fischer	5	2	0.4	3	0.6
Elsevier España	11	2	0.18181818181818182	9	0.8181818181818182
Masson	11	2	0.18181818181818182	9	0.8181818181818182
John Wiley & Sons, Inc.	12	2	0.16666666666666666	10	0.8333333333333334
Mary Ann Liebert	13	2	0.15384615384615385	11	0.8461538461538461
Taylor & Francis Group	15	2	0.13333333333333333	13	0.8666666666666667
Elsevier B.V.	16	2	0.125	14	0.875
Springer-Verlag	25	2	0.08	23	0.92
Blackwell	26	2	0.07692307692307693	24	0.9230769230769231
Sage	55	2	0.03636363636363636	53	0.9636363636363636
Sage Publications	85	2	0.023529411764705882	83	0.9764705882352941
Wiley-Blackwell	98	2	0.02040816326530612	96	0.9795918367346939
Informa Healthcare	130	2	0.015384615384615385	128	0.9846153846153847
Oxford University Press	138	2	0.014492753623188406	136	0.9855072463768116
AE Press	1	1	1.0	0	0.0
AEGIS Communications	1	1	1.0	0	0.0
AEP Press	1	1	1.0	0	0.0
AVES Publishing	1	1	1.0	0	0.0
Academy Of Medicine, Singapore	1	1	1.0	0	0.0
Academy of General Dentistry.	1	1	1.0	0	0.0
Academy of Managed Care Pharmacy	1	1	1.0	0	0.0
Academy of Medical Sciences of Bosnia and Herzegovina	1	1	1.0	0	0.0
Academy of Medical Sciences of I.R. Iran	1	1	1.0	0	0.0
Academy of Medicine of Malyasia, College of Pathologists	1	1	1.0	0	0.0
Accreditation Council for Graduate Medical Education	1	1	1.0	0	0.0
Acta Medica Belgica	1	1	1.0	0	0.0
Acta Odontologica Latinoamericana	1	1	1.0	0	0.0
Aerospace Medical Association	1	1	1.0	0	0.0
Alan Guttmacher Institute	1	1	1.0	0	0.0
Alcohol Research Documentation, Inc.	1	1	1.0	0	0.0
All India Institute Of Medical Sciences	1	1	1.0	0	0.0
Allergy and Immunology Society of Thailand	1	1	1.0	0	0.0
Aluna Publishing	1	1	1.0	0	0.0
Ambit Media	1	1	1.0	0	0.0
American Academy Of Orthopaedic Surgeons	1	1	1.0	0	0.0
American Academy Of Psychiatry And The Law	1	1	1.0	0	0.0
American Academy Of The History Of Dentistry	1	1	1.0	0	0.0
American Academy of Family Physicians	1	1	1.0	0	0.0
American Academy of General Practice.	1	1	1.0	0	0.0
American Academy of Insurance Medicine	1	1	1.0	0	0.0
American Academy of Periodontology.	1	1	1.0	0	0.0
American Animal Hospital Association	1	1	1.0	0	0.0
American Association Of Avian Pathologists	1	1	1.0	0	0.0
American Association Of Critical-Care Nurses (AACN)	1	1	1.0	0	0.0
American Association Of Zoo Veterinarians	1	1	1.0	0	0.0
American Association of Critical-Care Nurses	1	1	1.0	0	0.0
American Association of Critical-Care Nurses (AACN)	1	1	1.0	0	0.0
American Association of Nurse Anesthetists	1	1	1.0	0	0.0
American Board of Family Medicine	1	1	1.0	0	0.0
American Clinical And Climatological Association	1	1	1.0	0	0.0
American College of Physicians--American Society of Internal Medicine	1	1	1.0	0	0.0
American Dental Hygienists Association	1	1	1.0	0	0.0
American Health Information Management Association	1	1	1.0	0	0.0
American Medical Informatics Association	1	1	1.0	0	0.0
American Mosquito Control Association	1	1	1.0	0	0.0
American Podiatry Association	1	1	1.0	0	0.0
American Red Cross	1	1	1.0	0	0.0
American Roentgen Ray Society	1	1	1.0	0	0.0
American Society Of Radiologic Technologists	1	1	1.0	0	0.0
American Society of Consultant Pharmacists	1	1	1.0	0	0.0
American Society of Extra-Corporeal Technology.	1	1	1.0	0	0.0
American Society of Interventional Pain Physicians	1	1	1.0	0	0.0
American Society of Parasitologists [etc.]	1	1	1.0	0	0.0
Anesthesia Progress	1	1	1.0	0	0.0
Ankara Mikrobiyoloji Dernegi	1	1	1.0	0	0.0
Annals of Family Medicine, Inc.	1	1	1.0	0	0.0
Annual Reviews, inc.	1	1	1.0	0	0.0
Annual Reviews, inc. [etc.]	1	1	1.0	0	0.0
Ariesdue	1	1	1.0	0	0.0
Armed Forces Health Surveillance Center	1	1	1.0	0	0.0
Armed Forces Hospital	1	1	1.0	0	0.0
Asian Network for Scientific Information	1	1	1.0	0	0.0
Associação Médica Brasileira	1	1	1.0	0	0.0
Association of Avian Veterinarians	1	1	1.0	0	0.0
Association of Biomolecular Resource Facilities	1	1	1.0	0	0.0
Association of Physicians of India	1	1	1.0	0	0.0
Assot︠s︡iat︠s︡ii︠a︡ delovoĭ pressy Gruzii ;	1	1	1.0	0	0.0
Australasian Medical Publishing Co.	1	1	1.0	0	0.0
Aušra	1	1	1.0	0	0.0
Ayub Medical College	1	1	1.0	0	0.0
Bas̜kent University	1	1	1.0	0	0.0
Beijing da xue	1	1	1.0	0	0.0
Biomedical Research Foundation	1	1	1.0	0	0.0
Borden Institute, US Army Medical Center of Excellence	1	1	1.0	0	0.0
Boulder, Co	1	1	1.0	0	0.0
Brazilian Society of Assisted Reproduction	1	1	1.0	0	0.0
Breakaway Media	1	1	1.0	0	0.0
C.M.B. Association	1	1	1.0	0	0.0
CJU Communications	1	1	1.0	0	0.0
Canadian Dental Association	1	1	1.0	0	0.0
Canadian Dental Hygienists Association	1	1	1.0	0	0.0
Canadian Diabetes Association	1	1	1.0	0	0.0
Canadian Society for Clinical Investigation	1	1	1.0	0	0.0
Carol Davila University Press	1	1	1.0	0	0.0
Casa Editrice Licinio Cappelli	1	1	1.0	0	0.0
Central Police University Press	1	1	1.0	0	0.0
Ceska Lekarska Spolecnost	1	1	1.0	0	0.0
Ceska Lekarska Spolecnost J. Ev. Purkyne	1	1	1.0	0	0.0
Ceská lékarska spolecnost J. E. Purkyne	1	1	1.0	0	0.0
Ceská lékarská spolecnost	1	1	1.0	0	0.0
Ceská lékarská spolecnost J. E. Purkyne	1	1	1.0	0	0.0
Ceská lékarská spolecnost J.E. Purkyne	1	1	1.0	0	0.0
Ceskoslovenska Lekarska Spolecnost	1	1	1.0	0	0.0
China Science Publishing & Media Ltd.	1	1	1.0	0	0.0
Chirurgie - Servis o.s.	1	1	1.0	0	0.0
Clarivate Analytics	1	1	1.0	0	0.0
Cleveland Clinic Educational Foundation	1	1	1.0	0	0.0
Clinical And Experimental Rheumatology S.A.S	1	1	1.0	0	0.0
Clinical Laboratory Publications	1	1	1.0	0	0.0
Clinics Cardive Pub.	1	1	1.0	0	0.0
Cognizant Communications	1	1	1.0	0	0.0
Colégio Brasileiro de Cirurgia Digestiva	1	1	1.0	0	0.0
College of Physicians and Surgeons Pakistan	1	1	1.0	0	0.0
Color Design	1	1	1.0	0	0.0
Communauté et santé mentale	1	1	1.0	0	0.0
Consociazione Nazionale delle Associazioni Infermiere/i	1	1	1.0	0	0.0
Cooperativa epidemiologia e prevenzione	1	1	1.0	0	0.0
Coordinación de Educación en Salud, División de Innovación Educativa	1	1	1.0	0	0.0
Copernicus International	1	1	1.0	0	0.0
Croatian Dermatovenerological Society	1	1	1.0	0	0.0
CryoLetters	1	1	1.0	0	0.0
Daedalus Enterprises for the American Association for Respiratory Therapy	1	1	1.0	0	0.0
Data Trace Pub. Co.	1	1	1.0	0	0.0
Den Alm Danske Laegerforening	1	1	1.0	0	0.0
Dennis Barber Ltd.	1	1	1.0	0	0.0
Deutscher Ärzte-Verlag	1	1	1.0	0	0.0
Dietitians of Canada	1	1	1.0	0	0.0
Discovery medicine	1	1	1.0	0	0.0
Doku Sayō Kenkyūkai	1	1	1.0	0	0.0
Dō Gakkai	1	1	1.0	0	0.0
Dustri-Verlag Dr. K. Feistle	1	1	1.0	0	0.0
Dustri-Verlag Dr. Karl Feistle.	1	1	1.0	0	0.0
Editions Elsevier	1	1	1.0	0	0.0
Editorial Board Of Acta Urologica Japonica	1	1	1.0	0	0.0
Editorial Office of Gut and Liver	1	1	1.0	0	0.0
Editura Celsius	1	1	1.0	0	0.0
"Editura Medicală Universitară ""Iuliu Haţieganu"""	1	1	1.0	0	0.0
Edizioni Internazionali srl	1	1	1.0	0	0.0
Edward H. Angle Society of Orthodontia.	1	1	1.0	0	0.0
Elsevier Academic Press	1	1	1.0	0	0.0
Elsevier España, S.L.	1	1	1.0	0	0.0
Elsevier Taiwan LLC.	1	1	1.0	0	0.0
Elsevier/AP	1	1	1.0	0	0.0
Emerald Pub.	1	1	1.0	0	0.0
Esmon Publicidad	1	1	1.0	0	0.0
Ethnicity & Disease, Inc.	1	1	1.0	0	0.0
European Association for Cardio-Thoracic Surgery	1	1	1.0	0	0.0
European Directorate for the Quality of Medicines	1	1	1.0	0	0.0
Éditions ESKA	1	1	1.0	0	0.0
Ėskulap	1	1	1.0	0	0.0
Faculty of Medicine, Makerere University	1	1	1.0	0	0.0
Faculty of Pharmacy, University of Karachi	1	1	1.0	0	0.0
Food Hygienic Society	1	1	1.0	0	0.0
Food and Drug Administration, Taiwan	1	1	1.0	0	0.0
Forum Multimedia Pub.	1	1	1.0	0	0.0
Forum for Medical Ethics Society	1	1	1.0	0	0.0
Fukushima Society of Medical Science	1	1	1.0	0	0.0
Fundación Juan José López-Ibor	1	1	1.0	0	0.0
Fundación Revista Medicina (Buenos Aires)	1	1	1.0	0	0.0
Fundacja Polski Przegląd Chirurgiczny	1	1	1.0	0	0.0
GEOTAR-Media	1	1	1.0	0	0.0
Gaetano Conte Academy	1	1	1.0	0	0.0
Galen Prague	1	1	1.0	0	0.0
Gan To Kagaku Ryohosha	1	1	1.0	0	0.0
Gesellschaft Schweizer Tierärztinnen und Tierärzte	1	1	1.0	0	0.0
Gobierno de Navarra, Departamento de Salud	1	1	1.0	0	0.0
Govi-Verlag Pharmazautischer Verlag	1	1	1.0	0	0.0
Guilford	1	1	1.0	0	0.0
Guilford Publications	1	1	1.0	0	0.0
Gulf Federation for Cancer Control	1	1	1.0	0	0.0
Guoji Shudian	1	1	1.0	0	0.0
HEC Press	1	1	1.0	0	0.0
HMP	1	1	1.0	0	0.0
HMP Communications	1	1	1.0	0	0.0
Hacettepe Medical Center	1	1	1.0	0	0.0
Harborside Press	1	1	1.0	0	0.0
Health Effects Institute	1	1	1.0	0	0.0
Health Management Publications	1	1	1.0	0	0.0
Hellenic Society of Nuclear Medicine	1	1	1.0	0	0.0
Hellēnikē Psychiatrikē Hetaireia	1	1	1.0	0	0.0
Henry Stewart Publications	1	1	1.0	0	0.0
Histology and Histopathology	1	1	1.0	0	0.0
Hogrefe AG	1	1	1.0	0	0.0
Hopital De Baviere	1	1	1.0	0	0.0
Hua xue za zhi she	1	1	1.0	0	0.0
IJME]	1	1	1.0	0	0.0
IJPC	1	1	1.0	0	0.0
Icelandic Medical Association and the Medical Society of Reykjavik	1	1	1.0	0	0.0
Igaku Shoin.	1	1	1.0	0	0.0
Iniestares	1	1	1.0	0	0.0
Iniziative sanitarie	1	1	1.0	0	0.0
Institute Of Acupuncture And Moxibustion	1	1	1.0	0	0.0
Institute for Clinical Science.	1	1	1.0	0	0.0
Instituto Nacional de Salud Pública	1	1	1.0	0	0.0
Instituto Oswaldo Cruz	1	1	1.0	0	0.0
Intellisphere, LLC	1	1	1.0	0	0.0
International Antiviral Society-USA	1	1	1.0	0	0.0
International Center of Mental Health Policy and Economics	1	1	1.0	0	0.0
International Heart Journal Association	1	1	1.0	0	0.0
International Organisation of Forensic Odontostomatology	1	1	1.0	0	0.0
International Research and Cooperation Association for Bio & Socio-Sciences Advancement	1	1	1.0	0	0.0
International Rhinologic Society	1	1	1.0	0	0.0
International Scientific Literature, Inc.	1	1	1.0	0	0.0
International Skin Therapy Newsletter, Inc.	1	1	1.0	0	0.0
International Society Of Lymphology	1	1	1.0	0	0.0
International Society of Musculoskeletal and Neuronal Interactions	1	1	1.0	0	0.0
Iranian Society of Nephrology	1	1	1.0	0	0.0
Irish Medical Association	1	1	1.0	0	0.0
Israel Medical Association	1	1	1.0	0	0.0
Iuliu Haţieganu Medical Pub. House	1	1	1.0	0	0.0
Izd-vo Info-Media	1	1	1.0	0	0.0
İstiklâl Matbaacılık ve Gazetecilik Koll. Ort.	1	1	1.0	0	0.0
J. Michael Ryan Pub., Inc.	1	1	1.0	0	0.0
J. Michael Ryan Publishing, Inc.	1	1	1.0	0	0.0
J.-B. Baillière.	1	1	1.0	0	0.0
Japan Academy	1	1	1.0	0	0.0
Japan Atherosclerosis Society	1	1	1.0	0	0.0
Japan Endocrine Society	1	1	1.0	0	0.0
Japan Geriatrics Society	1	1	1.0	0	0.0
Japan Prosthodontic Society	1	1	1.0	0	0.0
Japan Society Of Clinical Hematology	1	1	1.0	0	0.0
Japanese Association for Laboratory Animal Science	1	1	1.0	0	0.0
Japanese Circulation Society	1	1	1.0	0	0.0
Japanese Pharmacological Society	1	1	1.0	0	0.0
Japanese Society Of Gastroenterology	1	1	1.0	0	0.0
Japanese Society Of Nuclear Medicine	1	1	1.0	0	0.0
Japanese Society Of Veterinary Science	1	1	1.0	0	0.0
Japanese Society for Dental Materials and Devices	1	1	1.0	0	0.0
Japanese Society of Internal Medicine	1	1	1.0	0	0.0
Japanese Society of Microbial Ecology	1	1	1.0	0	0.0
Japanese Urological Association	1	1	1.0	0	0.0
Jaypee Brothers Medical Publishers	1	1	1.0	0	0.0
Journal of Rheumatology Pub. Co.	1	1	1.0	0	0.0
Kare Publishing	1	1	1.0	0	0.0
Karl Demeter Verlag	1	1	1.0	0	0.0
Kathmandu University	1	1	1.0	0	0.0
Ke xue zhu ban she	1	1	1.0	0	0.0
Keio Gijuku Daigaku Igakubu	1	1	1.0	0	0.0
Kobe University School Of Medicine	1	1	1.0	0	0.0
Korean Society for Laboratory Medicine	1	1	1.0	0	0.0
Korean Society for Microbiology and Biotechnology	1	1	1.0	0	0.0
Korean Society for Parasitology	1	1	1.0	0	0.0
Korean Society of Nursing Science	1	1	1.0	0	0.0
Korean Society of Radiology	1	1	1.0	0	0.0
Kurume Univ., School of Medicine.	1	1	1.0	0	0.0
Lavoisier	1	1	1.0	0	0.0
Law Book Co.	1	1	1.0	0	0.0
Literatura Medica	1	1	1.0	0	0.0
MDAdvantage Insurance Co. of New Jersey	1	1	1.0	0	0.0
MEDICC	1	1	1.0	0	0.0
MEDPRESS	1	1	1.0	0	0.0
MRE Press	1	1	1.0	0	0.0
Magyar Pszichiátriai Társaság	1	1	1.0	0	0.0
Makedonska akademija na naukite i umetnostite	1	1	1.0	0	0.0
Malaysian Medical Association	1	1	1.0	0	0.0
Malaysian Society of Parasitology and Tropical Medicine	1	1	1.0	0	0.0
Mallet Conseil	1	1	1.0	0	0.0
Marshfield Clinic	1	1	1.0	0	0.0
Mary Ann Liebert Publishers	1	1	1.0	0	0.0
Massachusetts Eye and Ear Infirmary	1	1	1.0	0	0.0
MedWorks Media	1	1	1.0	0	0.0
MediMedia USA	1	1	1.0	0	0.0
Medical Association of Nippon Medical School	1	1	1.0	0	0.0
Medical Society Of The State Of North Carolina	1	1	1.0	0	0.0
Medicina Oral S.L.	1	1	1.0	0	0.0
Meditsina	1	1	1.0	0	0.0
Medpharm Publications	1	1	1.0	0	0.0
Medsport Press	1	1	1.0	0	0.0
Medycyna Praktyczna	1	1	1.0	0	0.0
Médecine et Hygiène	1	1	1.0	0	0.0
Microbiology Research Foundation	1	1	1.0	0	0.0
Millennium Medical Pub.	1	1	1.0	0	0.0
Minerva medica	1	1	1.0	0	0.0
Ministerio de Sanidad y Consumo	1	1	1.0	0	0.0
Missouri State Medical Association	1	1	1.0	0	0.0
Modern Commercial Press	1	1	1.0	0	0.0
Morion	1	1	1.0	0	0.0
Mosher & Linder, Inc.	1	1	1.0	0	0.0
MultiMedia Healthcare	1	1	1.0	0	0.0
Mymensingh Medical College	1	1	1.0	0	0.0
Nagoya University School Of Medicine	1	1	1.0	0	0.0
Nanfang yi ke da xue xue bao bian ji bu	1	1	1.0	0	0.0
Nankodo	1	1	1.0	0	0.0
Narodowy Instytut Zdrowia Publicznego--Państwowy Zakład Higieny	1	1	1.0	0	0.0
National Athletic Trainers' Association	1	1	1.0	0	0.0
National Black Nurses Association	1	1	1.0	0	0.0
National Cancer Registrars Association, Inc.	1	1	1.0	0	0.0
National Center for Health Statistics	1	1	1.0	0	0.0
National Institute of Environmental Health Sciences, [2000-	1	1	1.0	0	0.0
National Institute of Industrial Health	1	1	1.0	0	0.0
National Institute of Infectious Diseases	1	1	1.0	0	0.0
National Institute on Alcohol Abuse and Alcoholism	1	1	1.0	0	0.0
National Taiwan Normal University	1	1	1.0	0	0.0
National Toxicology Program	1	1	1.0	0	0.0
Naukovyĭ t︠s︡entr radiat︠s︡iĭnoï medyt︠s︡yny AMN Ukraïny	1	1	1.0	0	0.0
Nencki Institute of Experimental Biology	1	1	1.0	0	0.0
Neuroline	1	1	1.0	0	0.0
Nihon Allergy Gakkai	1	1	1.0	0	0.0
Nihon Hōshasen Gijutsu Gakkai	1	1	1.0	0	0.0
Nihon Igaku Butsuri Gakkai	1	1	1.0	0	0.0
Nihon Saikin Gakkai	1	1	1.0	0	0.0
Nihon Sangyō Eisei Gakkai	1	1	1.0	0	0.0
Nihon Shinkei Gakkai	1	1	1.0	0	0.0
Nihon University School of Dentistry	1	1	1.0	0	0.0
Nihon Yakugakkai	1	1	1.0	0	0.0
Nihon ishinkin Gakkai	1	1	1.0	0	0.0
Nippon Eisei Gakkai.	1	1	1.0	0	0.0
Nippon Kōshū Eisei Kyōkai.	1	1	1.0	0	0.0
Nippon Yakuri Gakkai.	1	1	1.0	0	0.0
Nizhegorodskai︠a︡ gosudarstvennai︠a︡ medit︠s︡inskai︠a︡ akademii︠a︡	1	1	1.0	0	0.0
"OOO ""Obshchestvo spet︠s︡ialistov po serdechnoĭ nedostatochnosti"""	1	1	1.0	0	0.0
OceanSide Publications	1	1	1.0	0	0.0
Oficyna Wydawnicza Politechniki Wrocławskiej	1	1	1.0	0	0.0
Okajima Foria Anatomika Yaponika Henshūbu	1	1	1.0	0	0.0
Okayama University Medical School	1	1	1.0	0	0.0
Oncology Nursing Press	1	1	1.0	0	0.0
Oncology Nursing Society	1	1	1.0	0	0.0
Ontario Health	1	1	1.0	0	0.0
Ordre des infirmières et infirmiers du Québec	1	1	1.0	0	0.0
PIME	1	1	1.0	0	0.0
Pacini Editore SpA	1	1	1.0	0	0.0
Pat Ediciones	1	1	1.0	0	0.0
Pda (Parenteral Drug Association)	1	1	1.0	0	0.0
Permanente Press	1	1	1.0	0	0.0
Permanyer Publications	1	1	1.0	0	0.0
Pharmaceutical Society of Japan	1	1	1.0	0	0.0
Pharmaceutical Society of Japan.	1	1	1.0	0	0.0
Physician Assistant Education Association	1	1	1.0	0	0.0
Physicians Continuing Education Corporation	1	1	1.0	0	0.0
Physicians Postgraduate Press	1	1	1.0	0	0.0
Physicians Postgraduate Press.	1	1	1.0	0	0.0
Physiological Society of Nigeria	1	1	1.0	0	0.0
Polemos	1	1	1.0	0	0.0
Polish Academy of Sciences. Committee of Veterinary Sciences ;	1	1	1.0	0	0.0
Polish Parasitological Society	1	1	1.0	0	0.0
Polish Physiological Society	1	1	1.0	0	0.0
Polska Akademia Nauk ;	1	1	1.0	0	0.0
Prelum	1	1	1.0	0	0.0
Professional Audience Communications	1	1	1.0	0	0.0
Professional Publishing Hungary Kft.	1	1	1.0	0	0.0
Publications Division of the American Academy of Family Physicians	1	1	1.0	0	0.0
Published by Hanley & Belfus for the Association	1	1	1.0	0	0.0
Pulse Marketing & Communications	1	1	1.0	0	0.0
Quintessence Publishing Co., Ltd.	1	1	1.0	0	0.0
Quintessence Verlags-GmbH	1	1	1.0	0	0.0
Quintessenz Verlags-GmbH	1	1	1.0	0	0.0
RIA Media Sphera	1	1	1.0	0	0.0
Radiation Research Society	1	1	1.0	0	0.0
Revista De Neurologia	1	1	1.0	0	0.0
Rhode Island Medical Society	1	1	1.0	0	0.0
Rila	1	1	1.0	0	0.0
Rinsho Biseibutsu Jinsoku Shindan Kenkyukai	1	1	1.0	0	0.0
Romanian Society of Ophthalmology	1	1	1.0	0	0.0
Rossiĭskai︠a︡ akademii︠a︡ medit︠s︡inskikh nauk	1	1	1.0	0	0.0
Royal Australian College of General Practitioners	1	1	1.0	0	0.0
Royal College of Psychiatrists	1	1	1.0	0	0.0
SAGE Publications in association with Southeastern Surgical Congress	1	1	1.0	0	0.0
SFSP ; Rennes : ENSP	1	1	1.0	0	0.0
SIMTI servizi	1	1	1.0	0	0.0
Sage Publications Ltd	1	1	1.0	0	0.0
Saned	1	1	1.0	0	0.0
School of Stomatology, Shanghai Jiao Tong University	1	1	1.0	0	0.0
Schweizerische Zahnärzte-Gesellschaft	1	1	1.0	0	0.0
Science & Medicine	1	1	1.0	0	0.0
Scientia Medica	1	1	1.0	0	0.0
Scientific American	1	1	1.0	0	0.0
Scientific Publications	1	1	1.0	0	0.0
Scientific and Technical Research Council of Turkey	1	1	1.0	0	0.0
Shandong University China-Japan Cooperation Center for Drug Discovery & Screen	1	1	1.0	0	0.0
Sichuan Sheng sheng wu yi xue gong cheng xue hui	1	1	1.0	0	0.0
Sichuan University	1	1	1.0	0	0.0
Sichuan yi xue yuan	1	1	1.0	0	0.0
Socidrogalcohol	1	1	1.0	0	0.0
Sociedad Argentina de Pediatría	1	1	1.0	0	0.0
Sociedad Chilena de Pediatría	1	1	1.0	0	0.0
Sociedad De Gastroenterologia Del Peru	1	1	1.0	0	0.0
Sociedad Española de Quimioterapia	1	1	1.0	0	0.0
Sociedad Mexicana de Ortopedia	1	1	1.0	0	0.0
Sociedad Médica de Santiago	1	1	1.0	0	0.0
Sociedade Portuguesa de Cirurgia Cardio-Torácica e Vascular	1	1	1.0	0	0.0
Societe Tunisienne Des Sciences Medicales	1	1	1.0	0	0.0
Society Of Japanese Virologists	1	1	1.0	0	0.0
Society for Antibacterial and Antifungal Agents, Japan	1	1	1.0	0	0.0
Society of Automotive Engineers	1	1	1.0	0	0.0
Society of Integrated Sciences	1	1	1.0	0	0.0
Society of Laparoendoscopic Surgeons	1	1	1.0	0	0.0
Society of Laparoscopic & Robotic Surgeons	1	1	1.0	0	0.0
Society of Teachers of Family Medicine	1	1	1.0	0	0.0
Società Italiana di Nefrologia.	1	1	1.0	0	0.0
Société Europa édition	1	1	1.0	0	0.0
Société médicale du Mali.	1	1	1.0	0	0.0
South Dakota State Medical Association	1	1	1.0	0	0.0
Southern Medical Association	1	1	1.0	0	0.0
Springer Basel AG	1	1	1.0	0	0.0
Springer Nature Switzerland AG	1	1	1.0	0	0.0
Sri Lanka Medical Association	1	1	1.0	0	0.0
Statistics Canada	1	1	1.0	0	0.0
Státní zdravotnické nakladatelství	1	1	1.0	0	0.0
Steinviks Bokforlag	1	1	1.0	0	0.0
Stephen Hancocks Ltd. in association with Dennis Barber Ltd.	1	1	1.0	0	0.0
Students at Cleveland-Marshall College of Law, Cleveland State University	1	1	1.0	0	0.0
Sveriges Lakarforbund	1	1	1.0	0	0.0
TRIOS	1	1	1.0	0	0.0
Taiwan hu li xue hui	1	1	1.0	0	0.0
Tech Science Press	1	1	1.0	0	0.0
Termedia	1	1	1.0	0	0.0
Texas Medical Assn.	1	1	1.0	0	0.0
The College	1	1	1.0	0	0.0
The Medical Letter	1	1	1.0	0	0.0
Tohoku University Medical Library	1	1	1.0	0	0.0
Tokai University School Of Medicine	1	1	1.0	0	0.0
Tokyo Shika Daigaku	1	1	1.0	0	0.0
Turkish Joint Diseases Foundation	1	1	1.0	0	0.0
Turkish Neurosurgi[c]al Society	1	1	1.0	0	0.0
Türk Algoloji (Aǧrı) Derneği	1	1	1.0	0	0.0
Türkiye Sinir ve Ruh Sağliği Derneği	1	1	1.0	0	0.0
U.S. Centers for Disease Control	1	1	1.0	0	0.0
Uitgeverij De Tijdstroom	1	1	1.0	0	0.0
Ulusal Travma ve Acil Cerrahi Derneği	1	1	1.0	0	0.0
Undersea and Hyperbaric Medical Society	1	1	1.0	0	0.0
United States. Agency for Healthcare Research and Quality	1	1	1.0	0	0.0
Univ. of Washington, School of Dentistry.	1	1	1.0	0	0.0
Universa Press	1	1	1.0	0	0.0
Universal Medical Press	1	1	1.0	0	0.0
Universidad del Valle, Facultad de Salud	1	1	1.0	0	0.0
Universidade de São Paulo, Escola de Enfermagem	1	1	1.0	0	0.0
Universita Degli Studi Di Pisa	1	1	1.0	0	0.0
University Health Partners of Hawaiʻi	1	1	1.0	0	0.0
University of Occupational and Environmental Health	1	1	1.0	0	0.0
University of Tokushima School of Medicine	1	1	1.0	0	0.0
University of Tokyo Press.	1	1	1.0	0	0.0
University of Wisconsin School of Medicine and Public Health ;	1	1	1.0	0	0.0
Univerzita Karlova v Praze - 1. lékařská fakulta	1	1	1.0	0	0.0
Ústav molekulárnej fyziológie a genetiky SAV	1	1	1.0	0	0.0
Van Zuiden Communications	1	1	1.0	0	0.0
Vandenhoeck & Ruprecht	1	1	1.0	0	0.0
Vereniging NTvG	1	1	1.0	0	0.0
Verlag Fur Medizinische Psychologie	1	1	1.0	0	0.0
Via Medica Journals	1	1	1.0	0	0.0
Vilans	1	1	1.0	0	0.0
WWF Verlag	1	1	1.0	0	0.0
Wei sheng yan jiu bian ji bu	1	1	1.0	0	0.0
Weston Medical Pub.	1	1	1.0	0	0.0
Wolters Kluwer - Medknow	1	1	1.0	0	0.0
Wolters Kluwer Health, Inc	1	1	1.0	0	0.0
Wolters Kluwer Health, Medknow	1	1	1.0	0	0.0
Women's Health and Action Research Centre	1	1	1.0	0	0.0
Wydawnictwo Uniwersytetu Przyrodniczego w Poznaniu	1	1	1.0	0	0.0
Yale Journal of Biology and Medicine	1	1	1.0	0	0.0
Združenje Slovenskih Dermatovenerologov	1	1	1.0	0	0.0
Zhejiang da xue xue bao bian ji bu	1	1	1.0	0	0.0
Zhongguo dang dai er ke za zhi she	1	1	1.0	0	0.0
Zhongguo gu shang bian ji bu	1	1	1.0	0	0.0
Zhongguo shi yan xue za zhi she	1	1	1.0	0	0.0
Zhongguo yi xue ke xue yuan	1	1	1.0	0	0.0
Zhongguo yi xue ke xue yuan.	1	1	1.0	0	0.0
Zhonghua Yixuehui	1	1	1.0	0	0.0
Zhonghua yi xue hui za zhi she	1	1	1.0	0	0.0
Zhonghua yi xue hui, Wai ke xue hui	1	1	1.0	0	0.0
Zhonghua yi xue za zhi she	1	1	1.0	0	0.0
Zhongshan da xue	1	1	1.0	0	0.0
Zoological Society of Japan	1	1	1.0	0	0.0
[IEEE]	1	1	1.0	0	0.0
[Longwoods]	1	1	1.0	0	0.0
igaku Shoin	1	1	1.0	0	0.0
published in the Cardiovascular Surgical Research Laboratories, Texas Heart Institute	1	1	1.0	0	0.0
AME Publishing Company	2	1	0.5	1	0.5
Akadémiai Kiadó	2	1	0.5	1	0.5
Associação Brasileira de Pós-Graduação em Saúde Coletiva	2	1	0.5	1	0.5
Aves	2	1	0.5	1	0.5
Dustri-Verlag	2	1	0.5	1	0.5
Editura Academiei Române	2	1	0.5	1	0.5
Elsevier Ltd	2	1	0.5	1	0.5
Emerald	2	1	0.5	1	0.5
Galenos Yayınevi	2	1	0.5	1	0.5
Pacini editore	2	1	0.5	1	0.5
Panstwowe Wydawnictwo Naukowe	2	1	0.5	1	0.5
Science Press	2	1	0.5	1	0.5
University of Toronto Press	2	1	0.5	1	0.5
Wiley Periodicals, Inc.	2	1	0.5	1	0.5
Elsevier Trends Journals	3	1	0.3333333333333333	2	0.6666666666666666
Sciendo	3	1	0.3333333333333333	2	0.6666666666666666
Blackwell Munksgaard	4	1	0.25	3	0.75
Minerva Medica	4	1	0.25	3	0.75
Elsevier Doyma	5	1	0.2	4	0.8
Hindawi	5	1	0.2	4	0.8
Wiley Subscription Services, Inc.	5	1	0.2	4	0.8
American Society of Clinical Oncology	6	1	0.16666666666666666	5	0.8333333333333334
Elsevier Science Ltd.	6	1	0.16666666666666666	5	0.8333333333333334
Georg Thieme Verlag	6	1	0.16666666666666666	5	0.8333333333333334
RCNi	6	1	0.16666666666666666	5	0.8333333333333334
American Association for Cancer Research	7	1	0.14285714285714285	6	0.8571428571428571
Elsevier Masson SAS	7	1	0.14285714285714285	6	0.8571428571428571
Wolters Kluwer Health	7	1	0.14285714285714285	6	0.8571428571428571
De Gruyter	8	1	0.125	7	0.875
Medknow	8	1	0.125	7	0.875
Pergamon Press.	8	1	0.125	7	0.875
Wolters Kluwer Health, Inc.	8	1	0.125	7	0.875
American Society for Microbiology	9	1	0.1111111111111111	8	0.8888888888888888
Elsevier Masson	9	1	0.1111111111111111	8	0.8888888888888888
Institute of Electrical and Electronics Engineers	9	1	0.1111111111111111	8	0.8888888888888888
Munksgaard	10	1	0.1	9	0.9
Springer International Publishing	12	1	0.08333333333333333	11	0.9166666666666666
SAGE Publishing	13	1	0.07692307692307693	12	0.9230769230769231
American Medical Association	14	1	0.07142857142857142	13	0.9285714285714286
BMJ Pub. Group	15	1	0.06666666666666667	14	0.9333333333333333
Humana Press	15	1	0.06666666666666667	14	0.9333333333333333
S. Karger	16	1	0.0625	15	0.9375
Kluwer Academic/Plenum Publishers	18	1	0.05555555555555555	17	0.9444444444444444
IOS Press	20	1	0.05	19	0.95
Blackwell Scientific Publications	24	1	0.041666666666666664	23	0.9583333333333334
John Wiley & Sons	29	1	0.034482758620689655	28	0.9655172413793104
Thieme	29	1	0.034482758620689655	28	0.9655172413793104
Wiley-Liss	35	1	0.02857142857142857	34	0.9714285714285714
Mary Ann Liebert, Inc.	45	1	0.022222222222222223	44	0.9777777777777777
Elsevier Science	66	1	0.015151515151515152	65	0.9848484848484849
: Dipartimento di Medicina Veterinaria e Produzioni Animali, Università degli	1	0	0.0	1	1.0
A.R. Liss	1	0	0.0	1	1.0
ACS Publications	3	0	0.0	3	1.0
AEPress, Ltd	1	0	0.0	1	1.0
AIP Publishing	1	0	0.0	1	1.0
AO Research Institute	1	0	0.0	1	1.0
AOSIS Publishing	4	0	0.0	4	1.0
APA Division 16 (School Psychology)	1	0	0.0	1	1.0
APS Press	1	0	0.0	1	1.0
ASAE	1	0	0.0	1	1.0
ASET - The Neurodiagnostic Society	1	0	0.0	1	1.0
ASM Press	1	0	0.0	1	1.0
AVES	2	0	0.0	2	1.0
Ablex.	1	0	0.0	1	1.0
Academia Brasileira De Ciencias	1	0	0.0	1	1.0
Academy Of Traditional Chinese Medicine	1	0	0.0	1	1.0
Académie des sciences	1	0	0.0	1	1.0
Adis, Springer International	15	0	0.0	15	1.0
African Field Epidemiology Network	1	0	0.0	1	1.0
Akademiai Kiado	3	0	0.0	3	1.0
Akademija nauka i umjetnosti Bosne i Hercegovine	1	0	0.0	1	1.0
Alan R. Liss	1	0	0.0	1	1.0
Alan R. Liss, Inc.	1	0	0.0	1	1.0
Alcohol Research Documentation, Inc., Rutgers, The State University of New	1	0	0.0	1	1.0
American Academy Of Implant Dentistry ;	1	0	0.0	1	1.0
American Academy of Sleep Medicine	1	0	0.0	1	1.0
American Alliance For Health, Physical Education, Recreation, And Dance	1	0	0.0	1	1.0
American Association Of Blood Banks	1	0	0.0	1	1.0
American Association for Cancer Research, Inc.	1	0	0.0	1	1.0
American Association for the Advancement of Science	6	0	0.0	6	1.0
American Association of Colleges of Pharmacy	1	0	0.0	1	1.0
American Association of Immunologists	1	0	0.0	1	1.0
American Association of Immunologists, Inc.	1	0	0.0	1	1.0
American Association of Neuroscience Nurses	1	0	0.0	1	1.0
American Association of Pharmaceutical Scientists	1	0	0.0	1	1.0
American Association of Public Health Dentists	1	0	0.0	1	1.0
American Association on Intellectual and Developmental Disabilities	2	0	0.0	2	1.0
American Chemical Society	26	0	0.0	26	1.0
American Chemical Society.	5	0	0.0	5	1.0
American College of Allergy, Asthma, and Immunology	1	0	0.0	1	1.0
American Dairy Science Association	1	0	0.0	1	1.0
American Dental Association	1	0	0.0	1	1.0
American Diabetes Association	2	0	0.0	2	1.0
American Elsevier.	1	0	0.0	1	1.0
American Gastroenterological Association	1	0	0.0	1	1.0
American Institute Of Physics	1	0	0.0	1	1.0
American Institute of Mathematical Sciences;	1	0	0.0	1	1.0
American Institute of Physics	3	0	0.0	3	1.0
American Physical Society	2	0	0.0	2	1.0
American Physiological Society	12	0	0.0	12	1.0
American Phytopathological Society	1	0	0.0	1	1.0
American Phytopathological Society]	1	0	0.0	1	1.0
American Psychiatric Association	3	0	0.0	3	1.0
American Psychiatric Press	1	0	0.0	1	1.0
American Psychological Assn.	3	0	0.0	3	1.0
American Psychological Association	25	0	0.0	25	1.0
American Psychological Association, Division of Health Psychology	1	0	0.0	1	1.0
American Public Health Association	1	0	0.0	1	1.0
American Society For Microbiology	2	0	0.0	2	1.0
American Society Of Mechanical Engineers	1	0	0.0	1	1.0
American Society for Bone and Mineral Research	1	0	0.0	1	1.0
American Society for Cell Biology	2	0	0.0	2	1.0
American Society for Clinical Investigation	2	0	0.0	2	1.0
American Society for Healthcare Risk Management of the American Hospital	1	0	0.0	1	1.0
American Society for Microbiology.	2	0	0.0	2	1.0
American Society for Pharmacology and Experimental Therapeutics	3	0	0.0	3	1.0
American Society for Pharmacology and Experimental Therapeutics, etc.]	1	0	0.0	1	1.0
American Society for Photobiology	1	0	0.0	1	1.0
American Society for Veterinary Clinical Pathology	1	0	0.0	1	1.0
American Society of Animal Science	1	0	0.0	1	1.0
American Society of Hematology	2	0	0.0	2	1.0
American Society of Nephrology	3	0	0.0	3	1.0
American Society of Neuroradiology	1	0	0.0	1	1.0
American Society of Pharmacognosy.	1	0	0.0	1	1.0
American Society of Plant Biologists	1	0	0.0	1	1.0
American Society of Tropical Medicine and Hygiene	1	0	0.0	1	1.0
American Speech and Hearing Assn.	1	0	0.0	1	1.0
American Speech-Language-Hearing Association	3	0	0.0	3	1.0
American Spinal Injury Association	1	0	0.0	1	1.0
American Thoracic Society	3	0	0.0	3	1.0
American Veterinary Medical Association	2	0	0.0	2	1.0
Aran Ediciones	1	0	0.0	1	1.0
Arnette-Blackwell	1	0	0.0	1	1.0
Ars Polona-Ruch	1	0	0.0	1	1.0
Asian Association for the Study of Diabetes and Blackwell Pub.	1	0	0.0	1	1.0
Asian Pacific Organization for Cancer Prevention	1	0	0.0	1	1.0
Asian Society of Gynecologic Oncology	1	0	0.0	1	1.0
Asociación Española de Bioética y Ética Médica	1	0	0.0	1	1.0
Asociación Argentina de Microbiología.	1	0	0.0	1	1.0
Aspen Publications	1	0	0.0	1	1.0
Associacao Brasileira de Enfermagem	1	0	0.0	1	1.0
Associação Brasileira de Divulgação Científica	1	0	0.0	1	1.0
Associação Brasileira de Psiquiatria	1	0	0.0	1	1.0
Associação Paulista de Medicina	1	0	0.0	1	1.0
Associação de Medicina Intensiva Brasileira	1	0	0.0	1	1.0
Associação de Psiquiatria do Rio Grande do Sul	1	0	0.0	1	1.0
Association For Ocular Pharmacology And Therapeutics	1	0	0.0	1	1.0
Association For Research In Vision And Ophthalmology (Arvo)	1	0	0.0	1	1.0
Association Of University Radiologists	1	0	0.0	1	1.0
Association for Politics and the Life Sciences	1	0	0.0	1	1.0
Association for Research in Vision and Ophthalmology	1	0	0.0	1	1.0
Association for Research in Vision and Ophthalmology (ARVO)	1	0	0.0	1	1.0
Association of American Medical Colleges	1	0	0.0	1	1.0
Association of Basic Medical Sciences of FBIH	1	0	0.0	1	1.0
Association of Schools of Allied Health Professions	1	0	0.0	1	1.0
Association of the Scientific Medical Societies in Germany	1	0	0.0	1	1.0
Australian Dental Association	1	0	0.0	1	1.0
Australian Journal of Public Health, Australian Institute for Primary Care,	1	0	0.0	1	1.0
BMJ	6	0	0.0	6	1.0
BMJ Pub. Group [etc.]	1	0	0.0	1	1.0
BMJ Publishing	1	0	0.0	1	1.0
BMJ Publishing Group	11	0	0.0	11	1.0
BMJ Publishing Group Ltd	3	0	0.0	3	1.0
BMJ Publishing Group Ltd & British Society of Gastroenterology	1	0	0.0	1	1.0
BMJ Publishing Group Ltd & British Thoracic Society	1	0	0.0	1	1.0
BMJ Publishing Group Ltd.	4	0	0.0	4	1.0
Baishideng Publishing Group	1	0	0.0	1	1.0
Balliere Tindall	1	0	0.0	1	1.0
Baltzer Science Publishers	1	0	0.0	1	1.0
Begell House	7	0	0.0	7	1.0
Begell House, Inc.	1	0	0.0	1	1.0
Bentham Science	3	0	0.0	3	1.0
Bentham Science Pub.	1	0	0.0	1	1.0
Bentham Science Publishers	50	0	0.0	50	1.0
BioMed Central	132	0	0.0	132	1.0
BioMed Central Ltd	3	0	0.0	3	1.0
BioMed Central Ltd.	5	0	0.0	5	1.0
BioMedCentral	1	0	0.0	1	1.0
BioOne	1	0	0.0	1	1.0
BioScientifica	4	0	0.0	4	1.0
Biomed Central	5	0	0.0	5	1.0
Biomed Central, Ltd	1	0	0.0	1	1.0
BiomedCentral	1	0	0.0	1	1.0
Biometric Society	1	0	0.0	1	1.0
Birkhaüser	1	0	0.0	1	1.0
Birkhäuser	2	0	0.0	2	1.0
Blackwell Pub	1	0	0.0	1	1.0
Blackwell Pub.	14	0	0.0	14	1.0
Blackwell Pub. Asia	2	0	0.0	2	1.0
Blackwell Pub. Asia Pty	1	0	0.0	1	1.0
Blackwell Publishers	6	0	0.0	6	1.0
Blackwell Publishers ;	1	0	0.0	1	1.0
Blackwell Publishing	9	0	0.0	9	1.0
Blackwell Publishing Asia	1	0	0.0	1	1.0
Blackwell Publishing Inc. for Sigma Theta Tau International	1	0	0.0	1	1.0
Blackwell Publishing on behalf of the Japanese Society of Developmental	1	0	0.0	1	1.0
Blackwell Publishing, Inc. on behalf of the Society for Conservation	1	0	0.0	1	1.0
Blackwell Science	21	0	0.0	21	1.0
Blackwell Science Asia	5	0	0.0	5	1.0
Blackwell Science Ltd.	5	0	0.0	5	1.0
Blackwell Science in collaboration with the British Society of Plant	1	0	0.0	1	1.0
Blackwell Science, Inc.	1	0	0.0	1	1.0
Blackwell Scientific For The Royal Entomological Society	1	0	0.0	1	1.0
Blackwell Scientific Publications Ltd	1	0	0.0	1	1.0
Blackwell Scientific Publications on behalf of the Royal Society for	1	0	0.0	1	1.0
Blackwell Scientific Publications.	7	0	0.0	7	1.0
Blackwell Scientific Publishers and BIOS Scientific Publishers in association with	1	0	0.0	1	1.0
Blackwell Verlag	2	0	0.0	2	1.0
Brazilian Society of Cardiovascular Surgery	1	0	0.0	1	1.0
Brazilian Society of Urology	1	0	0.0	1	1.0
Brill	3	0	0.0	3	1.0
Bristol University Press	1	0	0.0	1	1.0
British Dental Journal	1	0	0.0	1	1.0
British Editorial Society of Bone & Joint Surgery	1	0	0.0	1	1.0
British Institute of Radiology	1	0	0.0	1	1.0
British Institute of Radiology.	1	0	0.0	1	1.0
British Medical Assn.	3	0	0.0	3	1.0
British Medical Association	3	0	0.0	3	1.0
British Veterinary Association	1	0	0.0	1	1.0
Butterworth-Heinemann	2	0	0.0	2	1.0
C. Slack.	1	0	0.0	1	1.0
C.B. Slack	1	0	0.0	1	1.0
CABI Pub.	1	0	0.0	1	1.0
CABI Publishing	1	0	0.0	1	1.0
CRC Press	2	0	0.0	2	1.0
CSIRO Pub.	3	0	0.0	3	1.0
CSIRO Publishing	1	0	0.0	1	1.0
Cairo University, production and hosting by Elsevier B. V.	1	0	0.0	1	1.0
Cambridge Press	1	0	0.0	1	1.0
Cambridge Univ. Press	1	0	0.0	1	1.0
Cambridge Univ. Press.	3	0	0.0	3	1.0
Cambridge University Press	37	0	0.0	37	1.0
Cambridge University Press.	2	0	0.0	2	1.0
Canadian Medical Association	4	0	0.0	4	1.0
Canadian Psychological Association	1	0	0.0	1	1.0
Canadian Science Publishing	5	0	0.0	5	1.0
Casa De Oswaldo Cruz	1	0	0.0	1	1.0
Cell Physiol Biochem Press GmbH & Co KG	2	0	0.0	2	1.0
Cell Press	23	0	0.0	23	1.0
Center for Nursing Historical Inquiry, University of Virginia, School of	1	0	0.0	1	1.0
Centro Editor Livreiro da Ordem dos Médicos	1	0	0.0	1	1.0
Charles B. Slack	1	0	0.0	1	1.0
Charles B. Slack, inc.	1	0	0.0	1	1.0
Chartered Society of Physiotherapy London	1	0	0.0	1	1.0
Chemical Society	1	0	0.0	1	1.0
Chichester	1	0	0.0	1	1.0
Chinese Academy of Medical Sciences	1	0	0.0	1	1.0
Chinese Anti-Cancer Association	1	0	0.0	1	1.0
Chinese Center for Disease Control and Prevention	1	0	0.0	1	1.0
Chinese Journal of Integrated Traditional and Western Medicine Press	1	0	0.0	1	1.0
Chinese Medical Association ; produced by Wolters Kluwer	1	0	0.0	1	1.0
Chinese Society of Immunology;	1	0	0.0	1	1.0
Chongqing yi ke da xue, di 2 lin chuang xue	1	0	0.0	1	1.0
Churchill Livingstone	16	0	0.0	16	1.0
Codon Publications	1	0	0.0	1	1.0
Cognitive Science Society, Inc.	1	0	0.0	1	1.0
Colegio Oficial de Psicológicas de Asturias	1	0	0.0	1	1.0
Colégio Brasileiro de Cirurgiões	1	0	0.0	1	1.0
Colégio Brasileiro de Parasitologia Veterinária	1	0	0.0	1	1.0
College of American Pathologists	1	0	0.0	1	1.0
College of Family Physicians of Canada	1	0	0.0	1	1.0
Cometa	1	0	0.0	1	1.0
Commonwealth Scientific and Industrial Research Organisation	1	0	0.0	1	1.0
Company Of Biologists Limited	2	0	0.0	2	1.0
Company of Biologists	1	0	0.0	1	1.0
Company of Biologists Ltd.	2	0	0.0	2	1.0
Confederation of Australian Critical Care Nurses	1	0	0.0	1	1.0
Conference Of Educational Administration Serving The Deaf And: Convention Of	1	0	0.0	1	1.0
Conselho Brasileiro de Oftalmologia	1	0	0.0	1	1.0
Consultants Bureau	1	0	0.0	1	1.0
Creative Nursing Management, Inc.	1	0	0.0	1	1.0
Croatian Society for Medical Biochemistry and Laboratory Medicine	1	0	0.0	1	1.0
Crop Science Society of America	1	0	0.0	1	1.0
Current Biology	2	0	0.0	2	1.0
Current Biology Ltd.	1	0	0.0	1	1.0
Current Medicine Group	1	0	0.0	1	1.0
Current Science	10	0	0.0	10	1.0
Current Science Inc.	5	0	0.0	5	1.0
Current Science, Inc.	2	0	0.0	2	1.0
D. A. Spandidos	1	0	0.0	1	1.0
D.A. Spandidos	3	0	0.0	3	1.0
DOVE Medical Press	2	0	0.0	2	1.0
Danish Medical Association	1	0	0.0	1	1.0
De Gruyter Open	1	0	0.0	1	1.0
Dental Foundation of Ribeirão Preto	1	0	0.0	1	1.0
Dental Press International	1	0	0.0	1	1.0
Department of Emergency Medicine, University of California, Irvine	1	0	0.0	1	1.0
Department of Ophthalmology & Visual Sciences, The Chinese University of	1	0	0.0	1	1.0
Department of Public Health, Kaohsiung Medical University	1	0	0.0	1	1.0
Dept. of Sports Medicine, Medical Faculty of Uludag University	1	0	0.0	1	1.0
Dove Medical Press	2	0	0.0	2	1.0
Dove Press Limited	1	0	0.0	1	1.0
Dr. K. C. Chaudhuri Foundation, co-published by Springer India	1	0	0.0	1	1.0
Duke Univ. Press.	1	0	0.0	1	1.0
Duke University Press	1	0	0.0	1	1.0
E Schweizerbartsche	1	0	0.0	1	1.0
E.N.T. Brazilian Society	1	0	0.0	1	1.0
EDK	1	0	0.0	1	1.0
EDP Sciences	1	0	0.0	1	1.0
ESCOM Science Publishers	1	0	0.0	1	1.0
Eastern Mediterranean Regional Office of the World Health Organization	1	0	0.0	1	1.0
Ecological Society of America	2	0	0.0	2	1.0
Ediciones Doyma S.A.	1	0	0.0	1	1.0
Editions Rodopi B.V	1	0	0.0	1	1.0
Editions Scientifiques Elsevier	3	0	0.0	3	1.0
Editorial Dept. of Chinese Journal of Traumatology	1	0	0.0	1	1.0
EduRad Publishing	1	0	0.0	1	1.0
Educational Pub. Foundation	1	0	0.0	1	1.0
Educational Pub. Foundation of the American Psychological Association	2	0	0.0	2	1.0
Educational Publishing Foundation	2	0	0.0	2	1.0
Educational Publishing Foundation of the American Psychological Association	1	0	0.0	1	1.0
Elsevier  Ltd.	1	0	0.0	1	1.0
Elsevier ;	1	0	0.0	1	1.0
Elsevier Advanced Technology	1	0	0.0	1	1.0
Elsevier Applied Science ;	1	0	0.0	1	1.0
Elsevier Applied Science Publishers	4	0	0.0	4	1.0
Elsevier Applied Science Publishing	1	0	0.0	1	1.0
Elsevier Australia	2	0	0.0	2	1.0
Elsevier B. V.	1	0	0.0	1	1.0
Elsevier B.V. ;	1	0	0.0	1	1.0
Elsevier B.V. on behalf of KeAi Communications Co. Ltd.	1	0	0.0	1	1.0
Elsevier Biomedical	3	0	0.0	3	1.0
Elsevier Biomedical Press	1	0	0.0	1	1.0
Elsevier Editora	1	0	0.0	1	1.0
Elsevier Editora Ltda	2	0	0.0	2	1.0
Elsevier España, Place of publication not identified	1	0	0.0	1	1.0
Elsevier España	12	0	0.0	12	1.0
Elsevier GmbH	3	0	0.0	3	1.0
Elsevier Health	1	0	0.0	1	1.0
Elsevier Health Science	1	0	0.0	1	1.0
Elsevier Health Science Division	1	0	0.0	1	1.0
Elsevier Health Sciences Division	14	0	0.0	14	1.0
Elsevier Inc. on behalf of American Society for Biochemistry and	2	0	0.0	2	1.0
Elsevier Ireland	1	0	0.0	1	1.0
Elsevier Ltd.	9	0	0.0	9	1.0
Elsevier Maason SAS	1	0	0.0	1	1.0
Elsevier Masson Editeur	1	0	0.0	1	1.0
Elsevier Mosby	1	0	0.0	1	1.0
Elsevier North Holland	1	0	0.0	1	1.0
Elsevier Saunders	1	0	0.0	1	1.0
Elsevier Science ;	1	0	0.0	1	1.0
Elsevier Science B.V	3	0	0.0	3	1.0
Elsevier Science B.V.	2	0	0.0	2	1.0
Elsevier Science Inc	1	0	0.0	1	1.0
Elsevier Science Inc.	4	0	0.0	4	1.0
Elsevier Science Ireland	4	0	0.0	4	1.0
Elsevier Science Ireland Ltd	2	0	0.0	2	1.0
Elsevier Science Ireland Ltd.	2	0	0.0	2	1.0
Elsevier Science Ltd	6	0	0.0	6	1.0
Elsevier Science Ltd. ;	1	0	0.0	1	1.0
Elsevier Science Pub. Co.	3	0	0.0	3	1.0
Elsevier Science Publisher	1	0	0.0	1	1.0
Elsevier Science Publisher B. V.	1	0	0.0	1	1.0
Elsevier Science Publishers	8	0	0.0	8	1.0
Elsevier Science Publishers, B.V.	1	0	0.0	1	1.0
Elsevier Science Publishing	4	0	0.0	4	1.0
Elsevier Science, Inc.	1	0	0.0	1	1.0
Elsevier Science, Ltd.	1	0	0.0	1	1.0
Elsevier Sciencem	1	0	0.0	1	1.0
Elsevier Scientific Pub. Co.	3	0	0.0	3	1.0
Elsevier Scientific Publishers	8	0	0.0	8	1.0
Elsevier Scientific Publishers Ireland	1	0	0.0	1	1.0
Elsevier Scientific Publishing	2	0	0.0	2	1.0
Elsevier Scientific.	1	0	0.0	1	1.0
Elsevier Sequoia	2	0	0.0	2	1.0
Elsevier Sp z.o.o.	1	0	0.0	1	1.0
Elsevier Urban & Fischer	1	0	0.0	1	1.0
Elsevier Urban & Partner	1	0	0.0	1	1.0
Elsevier for the American Society for Reproductive Medicine	1	0	0.0	1	1.0
Elsevier, 2002-	1	0	0.0	1	1.0
Elsevier, B.V.	1	0	0.0	1	1.0
Elsevier, Inc	1	0	0.0	1	1.0
Elsevier, Inc.	2	0	0.0	2	1.0
Elsevier, Ltd.	1	0	0.0	1	1.0
Elsevier-Masson	1	0	0.0	1	1.0
Elsevier-Masson SAS	1	0	0.0	1	1.0
Elsevier.	3	0	0.0	3	1.0
Elsevier/North Holland Biomedical Press	2	0	0.0	2	1.0
Elsevier/North-Holland	2	0	0.0	2	1.0
Elsevier/North-Holland Biomedical Press	3	0	0.0	3	1.0
Elsevier/North-Holland Biomedical Press.	8	0	0.0	8	1.0
Elsevier/North-Holland.	2	0	0.0	2	1.0
Elsevier/Saunders	1	0	0.0	1	1.0
Elsevier/north-Holland Biomedical Press	1	0	0.0	1	1.0
Emerald Group Pub.	1	0	0.0	1	1.0
Entomological Society of America	1	0	0.0	1	1.0
Epidemiology Program Office, Centers for Deasease Control and Prevention (CDC),	1	0	0.0	1	1.0
Epidemiology Program Office, Centers for Disease Control and Prevention, U.S.	1	0	0.0	1	1.0
Equinox	1	0	0.0	1	1.0
Escola Nacional De Saúde Pública, Fundação Oswaldo Cruz	1	0	0.0	1	1.0
Escola de Enfermagem da Universidade Federal do Rio Grande e	1	0	0.0	1	1.0
Escola de Enfermagem de Ribeirão Preto, Universidade de São Paulo	1	0	0.0	1	1.0
European Centre for Disease Prevention and Control (ECDC)	1	0	0.0	1	1.0
European Respiratory Society	2	0	0.0	2	1.0
Excerpta Media Asia, Ltd.	1	0	0.0	1	1.0
Excerpta Medica	4	0	0.0	4	1.0
F. Cass	1	0	0.0	1	1.0
F1000 Research Ltd	1	0	0.0	1	1.0
FBUN T︠S︡NII Ėpidemiologii Rospotrebnadzora	1	0	0.0	1	1.0
Fabrizio Serra	1	0	0.0	1	1.0
Faculdade de Odontologia de Bauru, USP	1	0	0.0	1	1.0
Facultad de Enfermería de la Universidad de Antioquia	1	0	0.0	1	1.0
Facultas Medica Hradec Kralove, Universitas Carolina	1	0	0.0	1	1.0
Facultas Universitatis [i.e. Facultas Medica Universitatis] Studiorum Zagrabiensis in cooperation	1	0	0.0	1	1.0
Faculty of Veterinary Medicine, University of Tripoli	1	0	0.0	1	1.0
Families, Systems & Health, Inc.	1	0	0.0	1	1.0
Family Process	1	0	0.0	1	1.0
Faraday Division, Royal Society of Chemistry	1	0	0.0	1	1.0
Federation of American Societies for Experimental Biology ;	1	0	0.0	1	1.0
Ferdinand Enke Verlag	2	0	0.0	2	1.0
Ferrata Storti Foundation	1	0	0.0	1	1.0
Fondazione clinica del lavoro edizioni : Distributed by PI-ME tipographia	1	0	0.0	1	1.0
Formosan Medical Association, Elsevier	1	0	0.0	1	1.0
Foundation of the American College of Healthcare Executives	1	0	0.0	1	1.0
Frontiers Editorial Office	1	0	0.0	1	1.0
Frontiers Media S. A.	2	0	0.0	2	1.0
Frontiers Media S.A.	1	0	0.0	1	1.0
Frontiers Media SA	2	0	0.0	2	1.0
Frontiers Research Foundation	1	0	0.0	1	1.0
Frontiers Research Foundation]	2	0	0.0	2	1.0
Fundación Clínica Médica Sur	1	0	0.0	1	1.0
Futura Pub. Co.	1	0	0.0	1	1.0
Future Medicine	10	0	0.0	10	1.0
Future Medicine Ltd	1	0	0.0	1	1.0
Future Medicine Ltd.	3	0	0.0	3	1.0
Future Science	5	0	0.0	5	1.0
G. Fischer	3	0	0.0	3	1.0
G. Thieme	1	0	0.0	1	1.0
G. Thieme Verlag	1	0	0.0	1	1.0
Galenos Publishing House	2	0	0.0	2	1.0
Galenos Yayinevi	1	0	0.0	1	1.0
Genetics Society of Japan	1	0	0.0	1	1.0
George Thieme	1	0	0.0	1	1.0
Gesellschaft für Medizinische Ausbildung in the Association of Scientific Medical	1	0	0.0	1	1.0
Ghana Medical Association	1	0	0.0	1	1.0
Grosse Verlag	1	0	0.0	1	1.0
Grune And Stratton	1	0	0.0	1	1.0
Grupo Aran	1	0	0.0	1	1.0
Guo jia yi yao guan li ju Yi liao qi	1	0	0.0	1	1.0
Gustav Fischer Verlag	3	0	0.0	3	1.0
Gustav Fisher	1	0	0.0	1	1.0
H. Stewart Publications	1	0	0.0	1	1.0
Hamadan University of Medical Sciences, School of Public Health, distributed	1	0	0.0	1	1.0
Hanley & Belfus, Inc.	1	0	0.0	1	1.0
Hans Huber	4	0	0.0	4	1.0
Harvard School of Public Health, François-Xavier Bagnoud Center for Health	1	0	0.0	1	1.0
Haworth Medical Press	1	0	0.0	1	1.0
Haworth Press	1	0	0.0	1	1.0
Healio.com	1	0	0.0	1	1.0
Health Administration Press	1	0	0.0	1	1.0
Health Communications Inc.	1	0	0.0	1	1.0
Health Protection Policy Branch, Office of Health Protection, Australian Government	1	0	0.0	1	1.0
Higher Education Press ;	1	0	0.0	1	1.0
Hindawi Limited	1	0	0.0	1	1.0
Hindawi Pub. Co.	1	0	0.0	1	1.0
Hindawi Pub. Corp	2	0	0.0	2	1.0
Hindawi Pub. Corp.	8	0	0.0	8	1.0
Hindawi Publishing	2	0	0.0	2	1.0
Hindawi Publishing Corporation	6	0	0.0	6	1.0
Hindawi in collaboration with Cambridge University Press	2	0	0.0	2	1.0
Hindawi in collaboration with John Wiley & Sons, Inc.	3	0	0.0	3	1.0
Hindawi in collaboration with SAGE Publishing	2	0	0.0	2	1.0
Hippokrates Verlag	2	0	0.0	2	1.0
Historical Metallurgy Society	1	0	0.0	1	1.0
Hogrefe	1	0	0.0	1	1.0
Hogrefe & Huber	1	0	0.0	1	1.0
Hong Kong Academy of Medicine Press	2	0	0.0	2	1.0
Hrvatsko znanstveno društvo za povijest zdravstvene kulture	1	0	0.0	1	1.0
Hua xi yi ke da xue Fu shu di 1	1	0	0.0	1	1.0
Huazhong University of Science and Technology	1	0	0.0	1	1.0
Human Factors and Ergonomics Society	1	0	0.0	1	1.0
Human Kinetics	2	0	0.0	2	1.0
Human Kinetics Pub.	1	0	0.0	1	1.0
Human Kinetics Publishers	5	0	0.0	5	1.0
Human Kinetics Publishers, Inc.	2	0	0.0	2	1.0
Human Sciences Press, Inc.	1	0	0.0	1	1.0
Human Sciences Press]	1	0	0.0	1	1.0
Humana Press, Inc.	1	0	0.0	1	1.0
Humana Press.	1	0	0.0	1	1.0
IEEE	2	0	0.0	2	1.0
IEEE Computer Society	4	0	0.0	4	1.0
IEEE Computer Society.	1	0	0.0	1	1.0
IMR Press	4	0	0.0	4	1.0
IOP Pub.	4	0	0.0	4	1.0
IOP Pub. Ltd.	2	0	0.0	2	1.0
IOP Publishing	2	0	0.0	2	1.0
IOP Publishing Ltd.	1	0	0.0	1	1.0
IOS Press ;	1	0	0.0	1	1.0
IOSPress	1	0	0.0	1	1.0
IRL Press at Oxford University Press	2	0	0.0	2	1.0
IWA Pub.	1	0	0.0	1	1.0
IWA Publishing	1	0	0.0	1	1.0
Ifjúsági Lapkiadó Vállalat.	1	0	0.0	1	1.0
Impact Journals	1	0	0.0	1	1.0
Impact Journals, LLC	1	0	0.0	1	1.0
Indian Pediatrics	1	0	0.0	1	1.0
Indonesian Society of Internal Medicine	1	0	0.0	1	1.0
Inform Healthcare	1	0	0.0	1	1.0
Informa UK Limited	1	0	0.0	1	1.0
Institut za medicinska istraz̆ivanja i medicinu rada	1	0	0.0	1	1.0
Institute Of Electrical And Electronics Engineers	1	0	0.0	1	1.0
Institute Of Physics	1	0	0.0	1	1.0
Institute of Agricultural Medicine	1	0	0.0	1	1.0
Institute of Electrical and Electronics Engineeers	1	0	0.0	1	1.0
Institute of Electrical and Electronics Engineers Engineering in Medicine and	1	0	0.0	1	1.0
Institute of Food Technologists	1	0	0.0	1	1.0
Institute of Parasitology, Biology Centrum the Academy of Sciences of	1	0	0.0	1	1.0
Institute of Physics Pub.	3	0	0.0	3	1.0
Institute of Physics Publishing	1	0	0.0	1	1.0
Instituto Brasileiro de Estudos e Pesquisas de Gastroenterologia.	1	0	0.0	1	1.0
Instituto Nacional de Salud	2	0	0.0	2	1.0
Instituto de Ensino e Pesquisa Albert Einstein	1	0	0.0	1	1.0
Instituto de Salud en el Trópico, Facultad de Medicina, Universidad	1	0	0.0	1	1.0
Inter-Research	1	0	0.0	1	1.0
International Dyslexia Association	1	0	0.0	1	1.0
International Institute of Anticancer Research	3	0	0.0	3	1.0
International Institute of Ecology	1	0	0.0	1	1.0
International Rehabilitation Council for Torture Victims (IRCT)	1	0	0.0	1	1.0
International Society of Global Health	1	0	0.0	1	1.0
International Society of Neuropathology	1	0	0.0	1	1.0
International Union of Crystallography	2	0	0.0	2	1.0
International Union of Physiological Sciences	1	0	0.0	1	1.0
International Universities Press	1	0	0.0	1	1.0
Ios Press	3	0	0.0	3	1.0
Iranian Society for Immunology & Allergy in association with Shīrāz	1	0	0.0	1	1.0
Irl Press At Oxford University Press	1	0	0.0	1	1.0
Istituti Editoriali e Poligrafici Internazionali	1	0	0.0	1	1.0
Istituto italiano di antropologia	1	0	0.0	1	1.0
Istituto sperimentale zooprofilattico.	1	0	0.0	1	1.0
Istituto superiore di sanità	1	0	0.0	1	1.0
Ivyspring International	1	0	0.0	1	1.0
Ivyspring International Publisher	2	0	0.0	2	1.0
Ivyspring International Publishers	1	0	0.0	1	1.0
Izdatelstvo Nauka	1	0	0.0	1	1.0
J B Lippincott	1	0	0.0	1	1.0
J.A. Barth	1	0	0.0	1	1.0
JCF Corp and the Society for Biomedical Diabetes Research/Lab &	1	0	0.0	1	1.0
JMIR Publications	2	0	0.0	2	1.0
JMIR Publications Inc.	1	0	0.0	1	1.0
James Cook University	1	0	0.0	1	1.0
Japan Epidemiological Association	1	0	0.0	1	1.0
Japan Geriatrics Society ;	1	0	0.0	1	1.0
Japan Neurosurgical Society.	1	0	0.0	1	1.0
Japan Oil Chemists' Society	1	0	0.0	1	1.0
Japan Society for Cell Biology	1	0	0.0	1	1.0
Japan Society of Magnetic Resonance in Medicine	1	0	0.0	1	1.0
Japanese Association of Forensic Toxicology	1	0	0.0	1	1.0
Japanese Editorial Committee of Annals of Thoracic and Cardiovascular Surgery	1	0	0.0	1	1.0
Japanese Society for Hygiene	1	0	0.0	1	1.0
Japanese Society of Animal Reproduction	1	0	0.0	1	1.0
Japanese Society of Bone and Mineral Metabolism	1	0	0.0	1	1.0
John Libbey And Company	1	0	0.0	1	1.0
John Libbey Eurotext	6	0	0.0	6	1.0
John Libbey Eurotext Ltd.	1	0	0.0	1	1.0
John Wiley	2	0	0.0	2	1.0
John Wiley & Sons Australia, Ltd on behalf of The	1	0	0.0	1	1.0
John Wiley & Sons Australia, Ltd.	1	0	0.0	1	1.0
John Wiley & Sons Inc.	2	0	0.0	2	1.0
John Wiley & Sons Ltd	3	0	0.0	3	1.0
John Wiley & Sons Ltd on behalf of Society on	1	0	0.0	1	1.0
John Wiley & Sons Ltd on behalf of the European	1	0	0.0	1	1.0
John Wiley & Sons Ltd, British Pharmacological Society and American	1	0	0.0	1	1.0
John Wiley & Sons Ltd.	7	0	0.0	7	1.0
John Wiley & Sons, Inc	3	0	0.0	3	1.0
John Wiley & Sons, Ltd.	2	0	0.0	2	1.0
John Wiley & sons	1	0	0.0	1	1.0
John Wiley And Sons	4	0	0.0	4	1.0
John Wiley And Sons Ltd	1	0	0.0	1	1.0
John Wiley and Sons	2	0	0.0	2	1.0
John Wiley and Sons Ltd	1	0	0.0	1	1.0
John Wiley and Sons, Inc.	2	0	0.0	2	1.0
Johns Hopkins University Press	9	0	0.0	9	1.0
Journal Of Rheumatology Publishing Co	1	0	0.0	1	1.0
Journal of Bone and Joint Surgery	1	0	0.0	1	1.0
Journal of Clinical Ethics	1	0	0.0	1	1.0
KJO	1	0	0.0	1	1.0
Kerman University of Medical Sciences	1	0	0.0	1	1.0
Kermanshah University of Medical Sciences	1	0	0.0	1	1.0
King Faisal Specialist Hospital and Research Centre	1	0	0.0	1	1.0
Kluwer	5	0	0.0	5	1.0
Kluwer Academic	9	0	0.0	9	1.0
Kluwer Academic For The International Society For Cardiovascular Pharmacotherapy	1	0	0.0	1	1.0
Kluwer Academic Pubishers	1	0	0.0	1	1.0
Kluwer Academic Publisher ;	1	0	0.0	1	1.0
Kluwer Academic Publishers	19	0	0.0	19	1.0
Korean Academy of Medical Science	1	0	0.0	1	1.0
Korean Association for the Study of the Liver	1	0	0.0	1	1.0
Korean Association of Internal Medicine	1	0	0.0	1	1.0
Korean Diabetes Association	1	0	0.0	1	1.0
Korean Endocrine Society	1	0	0.0	1	1.0
Korean Orthopaedic Association	1	0	0.0	1	1.0
Korean Society for Biochemistry and Molecular Biology	1	0	0.0	1	1.0
Korean Society for Molecular and Cellular Biology	1	0	0.0	1	1.0
Korean Society for Preventive Medicine	1	0	0.0	1	1.0
Korean Society of Anesthesiologists	1	0	0.0	1	1.0
Korean Society of Epidemiology	1	0	0.0	1	1.0
Korean Society of Gastroenterology	1	0	0.0	1	1.0
Korean Society of Medical Education	1	0	0.0	1	1.0
Korean Society of Veterinary Science	1	0	0.0	1	1.0
Korean Urological Association	1	0	0.0	1	1.0
La Société de biologie	1	0	0.0	1	1.0
Lancet Pub. Group	2	0	0.0	2	1.0
Life Science Alliance, LLC	1	0	0.0	1	1.0
Lin chuang er bi yan hou tou jing wai ke	1	0	0.0	1	1.0
Lippincott	1	0	0.0	1	1.0
Lippincott WIliams & Wilkins	1	0	0.0	1	1.0
Lippincott Williams &  Wilkins	1	0	0.0	1	1.0
Lippincott Williams & Wilkins for the American Society of Ophthalmic	1	0	0.0	1	1.0
Lippincott Williams & Wilkins, 2009-	1	0	0.0	1	1.0
Lippincott Williams & Wilkins, Inc.	4	0	0.0	4	1.0
Lippincott Williams And Wilkins	5	0	0.0	5	1.0
Lippincott Williams and Wilkins	4	0	0.0	4	1.0
Lippincott, Williams & Wilkins	7	0	0.0	7	1.0
Lippincott-Raven Publishers	1	0	0.0	1	1.0
Lippincott-Ravn Publisher	1	0	0.0	1	1.0
Lippincott.	1	0	0.0	1	1.0
Lisbon	1	0	0.0	1	1.0
Little, Brown And Company	1	0	0.0	1	1.0
London	1	0	0.0	1	1.0
London School Of Hygiene And Tropical Medicine	1	0	0.0	1	1.0
Longwoods Pub.	2	0	0.0	2	1.0
Longwoods Pub. Corp. [for the] Academy of Canadian Executive Nurses	1	0	0.0	1	1.0
M.A. Liebert	1	0	0.0	1	1.0
MA Healthcare	4	0	0.0	4	1.0
MA Healthcare Ltd	1	0	0.0	1	1.0
MAIK Nauka/Interperiodica	1	0	0.0	1	1.0
MCB University Press	1	0	0.0	1	1.0
MDPI	14	0	0.0	14	1.0
MDPI AG	1	0	0.0	1	1.0
MDPI Pub.	1	0	0.0	1	1.0
MDPI Publishing	1	0	0.0	1	1.0
MIT Press	3	0	0.0	3	1.0
MYJoVE Corporation	1	0	0.0	1	1.0
Macmillan Magazines Ltd.	1	0	0.0	1	1.0
Magnolia Press	1	0	0.0	1	1.0
Maruzen Co.	1	0	0.0	1	1.0
Mary Ann Liebert Inc.	1	0	0.0	1	1.0
Mary Ann Liebert, Inc. publishers	1	0	0.0	1	1.0
Massachusetts Medical Society.	1	0	0.0	1	1.0
Masson Doyma México, S.A	1	0	0.0	1	1.0
Medical Association of Pharmacopuncture Institute	1	0	0.0	1	1.0
Medical Association of Zenica-Doboj Canton	1	0	0.0	1	1.0
Medical Journals Sweden AB	2	0	0.0	2	1.0
Medical Library Association	1	0	0.0	1	1.0
Medical Services Department, Saudi Arabian Armed Forces, Ministry Of Defence	1	0	0.0	1	1.0
Medicinska Naklada	1	0	0.0	1	1.0
Medknow Publications	12	0	0.0	12	1.0
Medknow Publications Pvt. Ltd.	1	0	0.0	1	1.0
Medknow Publications and Media	1	0	0.0	1	1.0
Medpharm	1	0	0.0	1	1.0
Medwave Estudios Limitada	1	0	0.0	1	1.0
Methodist DeBakey Heart & Vascular Center	1	0	0.0	1	1.0
Microbiological Society Of Korea	1	0	0.0	1	1.0
Microbiology Society	5	0	0.0	5	1.0
Molecular Vision	1	0	0.0	1	1.0
Mosby	18	0	0.0	18	1.0
Mosby Yearbook	1	0	0.0	1	1.0
Mosby, Inc.	1	0	0.0	1	1.0
Mosby-Year Book	5	0	0.0	5	1.0
Mosby-Yearbook	1	0	0.0	1	1.0
Mosby.	2	0	0.0	2	1.0
Munksgaard International Publishers	3	0	0.0	3	1.0
Munksgaard.	1	0	0.0	1	1.0
NIHR Journals Library	1	0	0.0	1	1.0
NISC	2	0	0.0	2	1.0
Nanjing Jun Qu Nanjing Zong Yi Yuan zhu ban, Zhonghua	1	0	0.0	1	1.0
National Academy of Sciences	1	0	0.0	1	1.0
National Association For Healthcare Quality	1	0	0.0	1	1.0
National Association of Orthopaedic Nurses	1	0	0.0	1	1.0
National Center for American Indian and Alaska Native Mental Health	1	0	0.0	1	1.0
National Center for Infectious Diseases, Centers for Disease Control and	1	0	0.0	1	1.0
National Health Personnel Licensing Examination Board of the Republic of	1	0	0.0	1	1.0
National Institute of Environmental Health Sciences.	1	0	0.0	1	1.0
National Institute of Malaria Research ;	1	0	0.0	1	1.0
National Institute of Public Health - National Institute of Hygiene	1	0	0.0	1	1.0
National League for Nursing	1	0	0.0	1	1.0
National Legal Center for the Medically Dependent & Disabled and	1	0	0.0	1	1.0
Nature America	1	0	0.0	1	1.0
Nature America Inc.	1	0	0.0	1	1.0
Nature America Publishing	1	0	0.0	1	1.0
Nature Pub. Co.	1	0	0.0	1	1.0
Nature Pub. Group	34	0	0.0	34	1.0
Nature Publishing Company	1	0	0.0	1	1.0
Nature Publishing Group	33	0	0.0	33	1.0
Nature Publishing Group Specialist Journals	1	0	0.0	1	1.0
Nature Publishing Group UK	1	0	0.0	1	1.0
Nature Publishing Group in partnership with SBI, The Systems Biology	1	0	0.0	1	1.0
Nature Publishing Group on behalf of Cancer Research UK	1	0	0.0	1	1.0
Nature Publishing Group, Specialist Journals	1	0	0.0	1	1.0
Nature Publishing Group, a division of Macmillan Publishers Limited	1	0	0.0	1	1.0
Nepal Health Research Council	1	0	0.0	1	1.0
Nepal Medical Association	1	0	0.0	1	1.0
Nepal Ophthalmic Society	1	0	0.0	1	1.0
Neurology Section, American Physical Therapy Association	1	0	0.0	1	1.0
New York	2	0	0.0	2	1.0
New York Academy of Sciences ;	1	0	0.0	1	1.0
Nihon Rinpa Mōnaikei Gakkai	1	0	0.0	1	1.0
Nofer Institute of Occupational Medicine	2	0	0.0	2	1.0
Nordic Association of Occupational Safety and Health	1	0	0.0	1	1.0
Norske Laegeforening	1	0	0.0	1	1.0
North American Society for the Psychology of Sport and Physical	1	0	0.0	1	1.0
North Holland Publishing	2	0	0.0	2	1.0
North-Holland Pub. Co.	1	0	0.0	1	1.0
Nursecom	1	0	0.0	1	1.0
Nursecom, Inc.	1	0	0.0	1	1.0
Nurses Christian Fellowship	1	0	0.0	1	1.0
Nursing Publications]	1	0	0.0	1	1.0
Office international des épizooties	1	0	0.0	1	1.0
Office of Health Assessment and Translation, Division of the National	1	0	0.0	1	1.0
Old City Publishing	1	0	0.0	1	1.0
Open Learning on Enteric Pathogens	1	0	0.0	1	1.0
Open Mind Journals Ltd.	1	0	0.0	1	1.0
OpenJournals Pub.	1	0	0.0	1	1.0
Opragen Publications	1	0	0.0	1	1.0
Optica Publishing Group	4	0	0.0	4	1.0
Oxford Journals	2	0	0.0	2	1.0
Oxford Journals, Oxford University Press	1	0	0.0	1	1.0
Oxford University Press ;	1	0	0.0	1	1.0
Oxford University Press For The American Genetic Association	1	0	0.0	1	1.0
Oxford University Press for the European Society for Human Reproduction	1	0	0.0	1	1.0
Oxford University Press in association with the London School of	1	0	0.0	1	1.0
Oxford University Press.	2	0	0.0	2	1.0
PNG Publications and Scientific Research Limited	1	0	0.0	1	1.0
PagePress	2	0	0.0	2	1.0
PagePress Publications	1	0	0.0	1	1.0
Pakistan Medical Association	1	0	0.0	1	1.0
Palgrave Macmillan	2	0	0.0	2	1.0
Panminerva Medica	1	0	0.0	1	1.0
Pasifika Medical Association Group	1	0	0.0	1	1.0
Pasteur Institute of Iran	1	0	0.0	1	1.0
Paul Parey Scientific Publishers	1	0	0.0	1	1.0
Pediatria Medica E Chirurgica	1	0	0.0	1	1.0
PeerJ Inc.	1	0	0.0	1	1.0
Pergamon	8	0	0.0	8	1.0
Pergamon In Cooperation With The Reproductive Toxicology Center	1	0	0.0	1	1.0
Pergamon Press	26	0	0.0	26	1.0
Permanyer	3	0	0.0	3	1.0
Permanyer Mexico	1	0	0.0	1	1.0
Pharmaceutical Society of Korea.	1	0	0.0	1	1.0
Pleiades Publishing	1	0	0.0	1	1.0
Plovdiv Medical University ;	1	0	0.0	1	1.0
Polish Histochemical and Cytochemical Society at VM Media	1	0	0.0	1	1.0
Polish Psychiatric Association	1	0	0.0	1	1.0
Polish Society Of Pathologists	1	0	0.0	1	1.0
Polskie Towarzystwo Mikrobiologów	1	0	0.0	1	1.0
Portland Press	1	0	0.0	1	1.0
Portland Press On The Behalf Of The Biochemical Society	1	0	0.0	1	1.0
Portland Press on behalf of the Biochemical Society	2	0	0.0	2	1.0
Portland Press on behalf of the Medical Research Society and	1	0	0.0	1	1.0
Princeps Editions	1	0	0.0	1	1.0
Professional Press	1	0	0.0	1	1.0
Progrès en urologie, S.A.R.L	1	0	0.0	1	1.0
Project Hope	1	0	0.0	1	1.0
Psychology Press	3	0	0.0	3	1.0
Psychometric Society	1	0	0.0	1	1.0
Psychonomic Society	1	0	0.0	1	1.0
Public Health Agency of Canada = Agence de la santé	1	0	0.0	1	1.0
Public Library of Science	7	0	0.0	7	1.0
Publications Office, The Royal College of Surgeons of Edinburgh	1	0	0.0	1	1.0
Published By Elsevier In Association With The International Union Of	1	0	0.0	1	1.0
Published For The American Occupational Therapy Association By AJOT Pub.	1	0	0.0	1	1.0
Published by BMJ in partnership with the American Diabetes Association	1	0	0.0	1	1.0
Published by Blackwell Pub. on behalf of the Federation of	1	0	0.0	1	1.0
Published by Blackwell Scientific Publications for the Japanese Society of	1	0	0.0	1	1.0
Published by Cambridge University Press in association with the Clinical	1	0	0.0	1	1.0
Published by Elsevier Inc. on behalf of American Academy of	1	0	0.0	1	1.0
Published by Elsevier Ltd on behalf of College of Emergency	1	0	0.0	1	1.0
Published by Elsevier Ltd. on behalf of International Society of	1	0	0.0	1	1.0
Published by Elsevier Masson SAS on behalf of the Société	1	0	0.0	1	1.0
Published by Elsevier, copyright by British Mycological Society	1	0	0.0	1	1.0
Published by Montfort Press for the Medical Association of Malawi	1	0	0.0	1	1.0
Published by Portland Press on behalf of the Biochemical Society	1	0	0.0	1	1.0
Published by SPIE--the International Society for Optical Engineering  in	1	0	0.0	1	1.0
Published by Sage Publications on behalf of McGill University	1	0	0.0	1	1.0
Published by the MIT Press with the Cognitive Neuroscience Institute	1	0	0.0	1	1.0
Published by the Plant Communications Shanghai Office in association with	1	0	0.0	1	1.0
Published for ARS-AAOA by Wiley-Blackwell	1	0	0.0	1	1.0
Published for SCI by Wiley	1	0	0.0	1	1.0
Published for the Association of American Medical Colleges by Lippincott	1	0	0.0	1	1.0
Published for the Association of Physicians of Great Britain and	1	0	0.0	1	1.0
Published for the Cell Kinetics Society, the European Study Group	1	0	0.0	1	1.0
Published for the European Society of Human Reproduction and Embryology	1	0	0.0	1	1.0
Published for the Institute of Mathematics and its Applications by	1	0	0.0	1	1.0
Published for the Institute of Physiology of the Czechoslovak Academy	1	0	0.0	1	1.0
Published for the International Union of Biochemistry and Molecular Biology	1	0	0.0	1	1.0
Published for the Royal Entomological Society of London by Blackwell	1	0	0.0	1	1.0
Published for the Royal Microscopical Society by Blackwell Scientific Publications.	1	0	0.0	1	1.0
Published for the Society for Applied Bacteriology by Blackwell Science	1	0	0.0	1	1.0
Published for the Society for Applied Bacteriology by Blackwell Scientific	1	0	0.0	1	1.0
Published for the Society for Reproduction and Fertility by BioScientifica	1	0	0.0	1	1.0
Published on behalf of the British Nutrition Foundation by Blackwell	1	0	0.0	1	1.0
Published on behalf of the Canadian Institute of Food Science	1	0	0.0	1	1.0
Published on behalf of the European Sleep Research Society by	1	0	0.0	1	1.0
Published on behalf of the Nutrition Society by CABI Publishing	2	0	0.0	2	1.0
Quintessence Publishing Co., Inc.	1	0	0.0	1	1.0
Quintessenz Verlags-GMBH	2	0	0.0	2	1.0
RCNi ;	1	0	0.0	1	1.0
RSC Pub.	2	0	0.0	2	1.0
Radiological Society of North America	2	0	0.0	2	1.0
Radiological Society of North America, Inc.	1	0	0.0	1	1.0
Razi Vaccine and Serum Research Institute	1	0	0.0	1	1.0
Reidel.	1	0	0.0	1	1.0
Research and Publications Office of Jimma University	1	0	0.0	1	1.0
Residents and Faculty of the Dept. of Orthopaedics, University of	1	0	0.0	1	1.0
Richmond, Vic.	1	0	0.0	1	1.0
Rockefeller University Press	3	0	0.0	3	1.0
Routledge	54	0	0.0	54	1.0
Routledge, Taylor & Francis	2	0	0.0	2	1.0
Routledge, Taylor & Francis Group	3	0	0.0	3	1.0
Routledge/Taylor & Francis	1	0	0.0	1	1.0
Royal Academy of Medicine of Ireland	1	0	0.0	1	1.0
Royal College of General Practitioners	1	0	0.0	1	1.0
Royal College of Surgeons of England	1	0	0.0	1	1.0
Royal Society	2	0	0.0	2	1.0
Royal Society Pub.	1	0	0.0	1	1.0
Royal Society of Chemistry	15	0	0.0	15	1.0
Royal Society of London	1	0	0.0	1	1.0
Royal Swedish Academy of Sciences	1	0	0.0	1	1.0
S. Karger AG	1	0	0.0	1	1.0
S. Karger Medical and Scientific Publishers	1	0	0.0	1	1.0
SAGE	6	0	0.0	6	1.0
SAGE Publications in Association with American Cleft Palate-Craniofacial Association	1	0	0.0	1	1.0
SETAC Press	1	0	0.0	1	1.0
SLACK Inc.	1	0	0.0	1	1.0
STM Publishing	1	0	0.0	1	1.0
Sage Periodicals Press	2	0	0.0	2	1.0
Sage Publications In Association With The National Autistic Society	1	0	0.0	1	1.0
Sage Publications Inc	1	0	0.0	1	1.0
Sage Publications Inc.	1	0	0.0	1	1.0
Sage Publications for the Society for Personality and Social Psychology,	1	0	0.0	1	1.0
Sage Publications for the Southern Gerontological Society	1	0	0.0	1	1.0
Sage Publications, Inc.	5	0	0.0	5	1.0
Sage Publishers	2	0	0.0	2	1.0
Sage Pulbications	1	0	0.0	1	1.0
Sage in association with Experimental Psychology Society	1	0	0.0	1	1.0
Sage in association with the Association for Perioperative Practice	1	0	0.0	1	1.0
Sage on behalf of: American Federation for Medical Research	1	0	0.0	1	1.0
Sage.	1	0	0.0	1	1.0
Saif Zone, Sharjah, U.A.E.	1	0	0.0	1	1.0
Saned, S.A.	1	0	0.0	1	1.0
Saunders	9	0	0.0	9	1.0
Saunders.	5	0	0.0	5	1.0
Sax Institute	1	0	0.0	1	1.0
Scandinavian Society For Plant Physiology	1	0	0.0	1	1.0
Science China Press, co-published with Springer	1	0	0.0	1	1.0
Science Press ;	1	0	0.0	1	1.0
Science Press and Elsevier	1	0	0.0	1	1.0
Science press ;	1	0	0.0	1	1.0
Scientific Scholar on behalf of Indian Association of Dermatologists, Venereologists	1	0	0.0	1	1.0
Secretaria de Vigilância em Saúde do Ministério da Saúde	1	0	0.0	1	1.0
Section on Geriatrics of the American Physical Therapy Association	1	0	0.0	1	1.0
Segmento Farma Editores	1	0	0.0	1	1.0
Serdi Edition	1	0	0.0	1	1.0
Serdi Publisher ;	1	0	0.0	1	1.0
Servicio de Publicaciones de la Universidad De Navarra (departamentos de	1	0	0.0	1	1.0
Sestre Milosrdnice University Hospital, Institute for Clinical Medical Research	1	0	0.0	1	1.0
Shanghai Materia Medica	1	0	0.0	1	1.0
Shanghai University of Sport	1	0	0.0	1	1.0
Shiraz University of Medical Sciences	2	0	0.0	2	1.0
Si fa bu si fa jian ding ke xue yan	1	0	0.0	1	1.0
Sichuan da xue xue bao (yi xue ban) bian ji	1	0	0.0	1	1.0
Slack	2	0	0.0	2	1.0
Slack Inc.	1	0	0.0	1	1.0
Slack Incorporated	1	0	0.0	1	1.0
Slack.	1	0	0.0	1	1.0
Slovenian Chemical Society	1	0	0.0	1	1.0
Sociedad Brasileira De Cardiologia	1	0	0.0	1	1.0
Sociedad Colombiana De Obstetricia Y Ginecologia	1	0	0.0	1	1.0
Sociedad Española de Farmacia Hospitalaria	1	0	0.0	1	1.0
Sociedad Española de Rehabilitación.	1	0	0.0	1	1.0
Sociedad Mexicana De Alergia E Immunologia	1	0	0.0	1	1.0
Sociedade Brasileira Para O Desenvolvimento Da Pesquisa Em Cirurgia Curso	1	0	0.0	1	1.0
Sociedade Brasileira de Fonoaudiologia	1	0	0.0	1	1.0
Sociedade Brasileira de Medicina Tropical	1	0	0.0	1	1.0
Sociedade Brasileira de Nefrologia	1	0	0.0	1	1.0
Sociedade Brasileira de Pesquisa Odontológica	1	0	0.0	1	1.0
Sociedade Brasileira de Pneumologia e Tisilogia	1	0	0.0	1	1.0
Sociedade De Pediatria De Sao Paulo	1	0	0.0	1	1.0
Sociedade Portuguesa de Reumatologia	1	0	0.0	1	1.0
Societat Catalana de Salut Laboral	1	0	0.0	1	1.0
Society For Peripheral Vascular Nursing	1	0	0.0	1	1.0
Society for Applied Microbiology and Blackwell Pub.	1	0	0.0	1	1.0
Society for Biotechnology, Japan	1	0	0.0	1	1.0
Society for Chaos Theory in Psychology & Life Sciences	1	0	0.0	1	1.0
Society for Neuroscience	2	0	0.0	2	1.0
Society for the Publication of Acta Dermato-Venereologica	1	0	0.0	1	1.0
Society of Cardiovascular and Interventional Radiology	1	0	0.0	1	1.0
Society of Environmental Toxicology and Chemistry (SETAC)	1	0	0.0	1	1.0
Society of Nuclear Medicine	2	0	0.0	2	1.0
Société francophone de médecine tropicale et santé internationale	1	0	0.0	1	1.0
South African Medical Association	1	0	0.0	1	1.0
South African Medical Association, Health and Medical Pub. Group	1	0	0.0	1	1.0
South Pacific Underwater Medicine Society and the European Underwater and	1	0	0.0	1	1.0
Spektrum Akademischer Verlag	1	0	0.0	1	1.0
Springer Berlin Heidelberg	1	0	0.0	1	1.0
Springer France	1	0	0.0	1	1.0
Springer Heidelberg	3	0	0.0	3	1.0
Springer India	1	0	0.0	1	1.0
Springer India in co-pulbication with Indian Academy of Sciences	1	0	0.0	1	1.0
Springer India, in co-publication with Indian Academy of Sciences	1	0	0.0	1	1.0
Springer International	22	0	0.0	22	1.0
Springer International ;	1	0	0.0	1	1.0
Springer International Publ.	1	0	0.0	1	1.0
Springer International Publishing ;	1	0	0.0	1	1.0
Springer International Publishing AG	1	0	0.0	1	1.0
Springer International Publishing co-published with Korean Tissue Engineering and Regenerative	1	0	0.0	1	1.0
Springer International for the Japan Society of Anesthesiology	1	0	0.0	1	1.0
Springer International.	2	0	0.0	2	1.0
Springer Japan	9	0	0.0	9	1.0
Springer Milan	1	0	0.0	1	1.0
Springer Nature	7	0	0.0	7	1.0
Springer Nature Publishing	1	0	0.0	1	1.0
Springer Netherlands	6	0	0.0	6	1.0
Springer New York	1	0	0.0	1	1.0
Springer Pub. Co.	2	0	0.0	2	1.0
Springer Publishing	2	0	0.0	2	1.0
Springer Publishing Company	2	0	0.0	2	1.0
Springer Science + Business Media	9	0	0.0	9	1.0
Springer Science+ Business Media	1	0	0.0	1	1.0
Springer Science+Business Media	2	0	0.0	2	1.0
Springer Singapore	1	0	0.0	1	1.0
Springer Tokyo	2	0	0.0	2	1.0
Springer US	4	0	0.0	4	1.0
Springer Verlag Italia	1	0	0.0	1	1.0
Springer Verlag and the European Biophysical Societies Association	1	0	0.0	1	1.0
Springer Verlag.	1	0	0.0	1	1.0
Springer-	1	0	0.0	1	1.0
Springer-Verlag Berlin	2	0	0.0	2	1.0
Springer-Verlag France	2	0	0.0	2	1.0
Springer-Verlag Italia	5	0	0.0	5	1.0
Springer-Verlag New York Inc	1	0	0.0	1	1.0
Springer-Verlag New York Inc.	2	0	0.0	2	1.0
Springer-Verlag Tokyo	6	0	0.0	6	1.0
Springer-Verlag [etc.]	1	0	0.0	1	1.0
Springer.	5	0	0.0	5	1.0
SpringerOpen	3	0	0.0	3	1.0
Springer]	1	0	0.0	1	1.0
Springhouse Corp.	1	0	0.0	1	1.0
Springhouse Corporation	1	0	0.0	1	1.0
Steinkopff	2	0	0.0	2	1.0
Steinkopff.	1	0	0.0	1	1.0
Stockton Press	1	0	0.0	1	1.0
Sultan Qaboos University	1	0	0.0	1	1.0
Swansea University	1	0	0.0	1	1.0
Swiss Chemical Society	1	0	0.0	1	1.0
TIGIS, Ltd. in association with the National Institute of Public	1	0	0.0	1	1.0
Taehan Ŭi Sahakhoe	1	0	0.0	1	1.0
Taylor & Francis	145	0	0.0	145	1.0
Taylor & Francis Group, 2014-	1	0	0.0	1	1.0
Taylor & Francis Health Sciences	1	0	0.0	1	1.0
Taylor & Francis Online	1	0	0.0	1	1.0
Taylor & Francis, Inc.	1	0	0.0	1	1.0
Taylor and Francis	3	0	0.0	3	1.0
Tayor & Francis	1	0	0.0	1	1.0
Tehran University of Medical Sciences	1	0	0.0	1	1.0
Termedia sp. z.o.o.	1	0	0.0	1	1.0
Termedica	1	0	0.0	1	1.0
The Academy	1	0	0.0	1	1.0
The Korean Society of Genetics	1	0	0.0	1	1.0
The Lancet, Diabetes & Endocrinology	1	0	0.0	1	1.0
The Royal Society	2	0	0.0	2	1.0
The Society	2	0	0.0	2	1.0
The Union	1	0	0.0	1	1.0
The University	1	0	0.0	1	1.0
Thieme Medical	1	0	0.0	1	1.0
Thieme Medical Publishers	4	0	0.0	4	1.0
Thieme Stratton	2	0	0.0	2	1.0
Thieme-Stratton	2	0	0.0	2	1.0
Thieme.	2	0	0.0	2	1.0
Tianjin shi lao dong wei sheng yan jiu suo ;	1	0	0.0	1	1.0
Tinnitus Center, The State University Of New York, Health Science	1	0	0.0	1	1.0
Tissue Viability Society	1	0	0.0	1	1.0
Trägerverein Swiss Medical Weekly SMW	1	0	0.0	1	1.0
Turkish Association of Orthopaedics and Traumatology with publishing services by	1	0	0.0	1	1.0
Türk Patoloji Derneği	1	0	0.0	1	1.0
U.S. Agency for International Development and Johns Hopkins Bloomberg School	1	0	0.0	1	1.0
U.S. Dept. of Health and Human Services, Centers for Disease	1	0	0.0	1	1.0
U.S. Dept. of Health and Human Services, Centers for Disease	2	0	0.0	2	1.0
U.S. Dept. of Health and Human Services, Public Health Service,	1	0	0.0	1	1.0
U.S. Dept. of Health and Human Services, Public Health Service,	1	0	0.0	1	1.0
Ubiquity Press	4	0	0.0	4	1.0
Ulster Medical Society	1	0	0.0	1	1.0
Unidad de Congresos del Centro Médico Nacional.	1	0	0.0	1	1.0
Universidad Nacional De Cordoba, Facultad De Ciencias Medicas	1	0	0.0	1	1.0
Universidad Nacional de Lanús	1	0	0.0	1	1.0
Universidade De Sao Paulo. Faculdade De Higiene E Saude Publica	1	0	0.0	1	1.0
Universidade de São Paulo, Instituto de Medicina Tropical de São	1	0	0.0	1	1.0
Universitas Carolina Pragensis	1	0	0.0	1	1.0
University of California, Davis	1	0	0.0	1	1.0
University of Chicago Press	3	0	0.0	3	1.0
University of Puerto Rico Medical Sciences Campus	1	0	0.0	1	1.0
University of the Basque Country Press	1	0	0.0	1	1.0
Upsala Medical Society	1	0	0.0	1	1.0
Urban & Fischer Verlag	2	0	0.0	2	1.0
Urban & Vogel	2	0	0.0	2	1.0
Urban Und Vogel	1	0	0.0	1	1.0
Urology and Nephrology Research Center	1	0	0.0	1	1.0
Verduci	1	0	0.0	1	1.0
Verlag Hans Huber	1	0	0.0	1	1.0
Verlag Helvetica Chimica Acta ;	1	0	0.0	1	1.0
Via Medica Media sp. zo.o. VM	1	0	0.0	1	1.0
Vydavatelství Univerzity Palackého	1	0	0.0	1	1.0
W B Saunders	8	0	0.0	8	1.0
W.B. Saunders	42	0	0.0	42	1.0
W.B. Saunders Co.	8	0	0.0	8	1.0
W.B. Saunders Co. [etc.]	1	0	0.0	1	1.0
W.B. Saunders Company	1	0	0.0	1	1.0
W.B. Saunders For The Hospital Infection Society	1	0	0.0	1	1.0
W.B. Saunders For The Osteoarthritis Research Society	1	0	0.0	1	1.0
W.B. Saunders for the American Gastroenterological Association	1	0	0.0	1	1.0
WB Saunders Co.	1	0	0.0	1	1.0
WILEY-VCH	1	0	0.0	1	1.0
WILEY-VCH Verlag GmbH & Co. KGaA	1	0	0.0	1	1.0
Wageningen Academic Publishers	1	0	0.0	1	1.0
Walter De Gruyter	3	0	0.0	3	1.0
Walter de Gruyter	10	0	0.0	10	1.0
Walter de Gruyter GmbH	1	0	0.0	1	1.0
Walter de Gruyter Publishers	1	0	0.0	1	1.0
Wayne State University Press	1	0	0.0	1	1.0
West African College Of Physicians And West African College Of	1	0	0.0	1	1.0
Whurr Publishers	1	0	0.0	1	1.0
Whurr Publishers Ltd.	1	0	0.0	1	1.0
Wildlife Disease Association	1	0	0.0	1	1.0
Wiley & Sons	3	0	0.0	3	1.0
Wiley ;	2	0	0.0	2	1.0
Wiley Blackwell	7	0	0.0	7	1.0
Wiley Heyden	1	0	0.0	1	1.0
Wiley Interscience	2	0	0.0	2	1.0
Wiley Japan	1	0	0.0	1	1.0
Wiley Online Library	1	0	0.0	1	1.0
Wiley Periodicals	1	0	0.0	1	1.0
Wiley Periodicals Inc.	2	0	0.0	2	1.0
Wiley Periodicals, Inc on behalf of American Neurological Association	1	0	0.0	1	1.0
Wiley Periodicals, Inc. on behalf of the American Association for	1	0	0.0	1	1.0
Wiley Publishing Asia Pty Ltd	2	0	0.0	2	1.0
Wiley Publishing Asia Pty Ltd ;	1	0	0.0	1	1.0
Wiley Publishing on behalf of the Japanese Cancer Association	1	0	0.0	1	1.0
Wiley Subscription Services on behalf of The Water Environment Foundation	1	0	0.0	1	1.0
Wiley on behalf of American Association of Physicists in Medicine	1	0	0.0	1	1.0
Wiley on behalf of New Phytologist Trust	1	0	0.0	1	1.0
Wiley on behalf of The British Dietetic Association Ltd., [c1988-	1	0	0.0	1	1.0
Wiley on behalf of the Asia Pacific League of Associations	1	0	0.0	1	1.0
Wiley on behalf of the Chinese Orthopedic Association	1	0	0.0	1	1.0
Wiley on behalf of the Institute of Food Technologists	1	0	0.0	1	1.0
Wiley on behalf of the International Society for Neurochemistry	1	0	0.0	1	1.0
Wiley on behalf of the Japan Academy of Nursing Science	1	0	0.0	1	1.0
Wiley on behalf of the Japan Society of Obstetrics and	1	0	0.0	1	1.0
Wiley on behalf of the Japanese Teratology Society	1	0	0.0	1	1.0
Wiley on behalf of the Society for Experimental Biology, Association	1	0	0.0	1	1.0
Wiley on behalf of the Society for Leukocyte Biology	1	0	0.0	1	1.0
Wiley-Blackwell Munksgaard	1	0	0.0	1	1.0
Wiley-Blackwell Pub	1	0	0.0	1	1.0
Wiley-Blackwell Pub.	1	0	0.0	1	1.0
Wiley-Blackwell Pub. Asia	2	0	0.0	2	1.0
Wiley-Blackwell Publishing Asia	3	0	0.0	3	1.0
Wiley-Blackwell for the International Association for the Study of Obesity	1	0	0.0	1	1.0
Wiley-VCH	19	0	0.0	19	1.0
Wiley-VCH GmbH	1	0	0.0	1	1.0
Wiley-VCH Verlag	6	0	0.0	6	1.0
Wiley-VCH Verlag GmbH & Co. KGaA	2	0	0.0	2	1.0
Wiley.	2	0	0.0	2	1.0
WileyBlackwell Pub.	1	0	0.0	1	1.0
Williams & Wilkins	1	0	0.0	1	1.0
Williams And Wilkins	3	0	0.0	3	1.0
Williams and Wilkins	1	0	0.0	1	1.0
Wolter Kluwer-Medknow	1	0	0.0	1	1.0
Wolters Kluwer - Medknow Publications	1	0	0.0	1	1.0
Wolters Kluwer Health/Lippincott Williams & Wilkins	3	0	0.0	3	1.0
Wolters Kluwer on behalf of ASCRS and ESCRS	1	0	0.0	1	1.0
World Health Organization	1	0	0.0	1	1.0
World Health Organization, Regional Office for the Western Pacific	1	0	0.0	1	1.0
World Health Organization, on behalf of the European Observatory on	1	0	0.0	1	1.0
World Scientific Pub.	1	0	0.0	1	1.0
World Scientific Pub. Co.	1	0	0.0	1	1.0
World Scientific Publishing Europe Ltd.	1	0	0.0	1	1.0
Wroclaw Medical University	1	0	0.0	1	1.0
Wydawnictwo Uniwersytetu Jagiellońskiego	1	0	0.0	1	1.0
Xi bao yu fen zi mian yi xue za zhi	1	0	0.0	1	1.0
Ying yong sheng tai xue bao bian ji wei yuan	1	0	0.0	1	1.0
Yonsei University	1	0	0.0	1	1.0
ZAO 'Konsilium Medikum'	1	0	0.0	1	1.0
Zhejiang University Press	1	0	0.0	1	1.0
Zhong nan da xue xue bao (yi xue ban) bian	1	0	0.0	1	1.0
Zhongguo fei ai za zhi bian ji wei yuan hui	1	0	0.0	1	1.0
Zhongguo xue xi chong bing fang zhi za zhi bian	1	0	0.0	1	1.0
Zhongguo yao xue hui : Zhongguo Zhong yi yan jiu	1	0	0.0	1	1.0
Zhongguo ying yong sheng li xue za zhi bian ji	1	0	0.0	1	1.0
Zhonghua yi xue hui; Zhongguo yi xue ke xue yuan	1	0	0.0	1	1.0
[Edizioni Minerva Medica]	1	0	0.0	1	1.0
[Elsevier España]	1	0	0.0	1	1.0
[Oxford University Press	1	0	0.0	1	1.0
[Oxford, England]	1	0	0.0	1	1.0
de Gruyter	1	0	0.0	1	1.0
eLife Sciences Publications, Ltd.	1	0	0.0	1	1.0
published by Cambridge University Press for the Canadian Neurological Sciences	1	0	0.0	1	1.0
published by Elsevier for the Taiwan Society of Microbiology	1	0	0.0	1	1.0
published by Oxford University Press on behalf of the American	1	0	0.0	1	1.0
published by Wiley Periodicals, Inc. on behalf of the American	1	0	0.0	1	1.0
published by Wiley-Blackwell on behalf of the London School of	1	0	0.0	1	1.0
published by Wolters Kluwer-Medknow for the Nigerian Postgraduate Medical College	1	0	0.0	1	1.0
published on behalf of ACOTA by Wiley-Blackwell Publishing Asia	1	0	0.0	1	1.0
published on behalf of the Gerontological Society of America by	2	0	0.0	2	1.0
